sentence	start	end	text_name	words	chars
Aamun kaiken olen juossut.	101175	101201	lehtonen1910a	3	26
Aamun valkeneminen.	154673	154692	jarnefelt1913a	1	19
Äänet kuuluvat selvempinä.	612189	612215	lehtonen1910a	2	26
Ääni oli muuttunut huudoksi.	78256	78284	canth1886a	3	28
Ääni on Putkinotkon Käkriäisen.	789923	789954	lehtonen1910a	3	31
Aapeli alkaa olla jo pesty.	727041	727068	lehtonen1910a	4	27
Aapeli antoi ihmisveljelleen muka paremmat ehdot.	771575	771624	lehtonen1910a	5	49
Aapeli hirnahtelee vain.	753529	753553	lehtonen1910a	2	24
Aapeli istuu tyytyväisenä sokaisevassa savussa.	663488	663535	lehtonen1910a	4	47
Aapeli kääntelehtii, ähkää ja puhkaa.	702163	702200	lehtonen1910a	4	37
Aapeli kirjoittaa jotain.	758540	758565	lehtonen1910a	2	25
Aapeli kustantaa sokerit.	787935	787960	lehtonen1910a	2	25
Aapeli kuuluu siunailevan ja viheltävän.	752859	752899	lehtonen1910a	4	40
Aapeli kylpee vielä.	720105	720125	lehtonen1910a	2	20
Aapeli kysyy, että missä.	666463	666488	lehtonen1910a	3	25
Aapeli menee jo alas saunalle.	695885	695915	lehtonen1910a	4	30
Aapeli Muttinen näyttää hänelle lanttia.	630329	630369	lehtonen1910a	4	40
Aapeli Muttinen on ennättänyt kotoiseen asuun.	575696	575742	lehtonen1910a	5	46
Aapeli Muttinen tyytyi sinä kesänä siihen.	31227	31269	lehtonen1910a	5	42
Aapeli nauraa.	574730	574744	lehtonen1910a	1	14
Aapeli osti pallomaisen punaisen lyhdyn.	758891	758931	lehtonen1910a	4	40
Aapeli seisahtuu rannalle, katselee uimapaikkaa.	728552	728600	lehtonen1910a	4	48
Aapeli työntää kynän ja paperin tuonnemmaksi.	763299	763344	lehtonen1910a	5	45
Aapelin kamari on jo melkein valmis.	598341	598377	lehtonen1910a	5	36
Aapelista on pässi hiukan ilkeä.	685356	685388	lehtonen1910a	4	32
Aapoltakin pääsi itku.	112446	112468	pakkala1895a	2	22
Aavisti äidille kaikkein surullisinta ja katkerinta.	742416	742468	lehtonen1910a	5	52
Äh, äh.	381220	381227	lehtonen1910a	1	7
Äh, äh.	678688	678695	lehtonen1910a	1	7
Äh, öh.	380926	380933	lehtonen1910a	1	7
Ah, sinä pudistat päätäsi.	100809	100835	jarnefelt1913a	3	26
Ähä kutti, pelkäsivätpä sentään hänen miestään.	61119	61166	canth1886a	5	47
Aha, kammari makkama?	105523	105544	jarnefelt1913a	2	21
Ahaa, entäs nyt?	491998	492014	lehtonen1910a	2	16
Ähisi vain ja oli vihoissaan.	95278	95307	lassila1910a	4	29
Ahkerasti täytyi Aapon olla liikkeellä, anelemassa.	106093	106144	pakkala1895a	5	51
Ai, ai, kuinka se on vaikeata.	164666	164696	jarnefelt1916a	5	30
Ai, ai, makealtapa se ottaa.	717554	717582	lehtonen1910a	4	28
Aidan takana on karviaismarjapensaita, homeen hävittämiä.	584330	584387	lehtonen1910a	5	57
Aidan vieressä.	505270	505285	lehtonen1910a	1	15
Äidin silmiin vierähti kyyneliä.	119435	119467	pakkala1895a	3	32
Äidistä oli tuntunut ihan uskomattomalle.	26696	26737	pakkala1895a	4	41
Aika kuitenkin oli haihduttanut vähitellen halun.	29730	29779	pakkala1895a	5	49
Aika nykyinen.	89619	89633	jarnefelt1913a	1	14
Aikoo sitten uudestaan lauteille.	721047	721080	lehtonen1910a	3	33
Aina ahkeraa.	787421	787434	lehtonen1910a	1	13
Ainakin kolotiita ja korpinrasvaa.	32818	32852	lehtonen1910a	3	34
Ainoastaan kerran tai pari kesässä.	190161	190196	lehtonen1910a	4	35
Ainoastaan nuorimpia hän ajattelee ilolla.	325270	325312	lehtonen1910a	4	42
Ainoastaan osa järkälettä mahtuu syliin.	395397	395437	lehtonen1910a	4	40
Äiti ahdisti siihen.	680130	680150	lehtonen1910a	2	20
Äiti Elsan tullessa keitti jo riisryynipuuroa.	52309	52355	pakkala1895a	5	46
Äiti havahtuu.	148233	148247	jarnefelt1913a	1	14
Äiti itki.	72728	72738	pakkala1895a	1	10
Äiti katsoi Maria pitkään ja tutkivasti.	38355	38395	pakkala1895a	5	40
Äiti katsoi pitkistään Vappua.	61763	61793	pakkala1895a	3	30
Äiti kulkee ja kiertelee.	253563	253588	lehtonen1910a	3	25
Äiti meni häntä auttamaan, lapsi käsivarrella.	3063	3109	canth1886a	5	46
Äiti näyttää viimein vilkastuvan.	258063	258096	lehtonen1910a	3	33
Äiti nyökäytti päätään.	121317	121340	pakkala1895a	2	23
Äiti samassa otti vitsakimpun.	62054	62084	pakkala1895a	3	30
Äiti taittoi vitsat ja viskasi uuniin.	62301	62339	pakkala1895a	5	38
Äiti tanssii keskustassa.	147648	147673	jarnefelt1913a	2	25
Aivan entisensä näköinen.	185193	185218	jarnefelt1916a	2	25
Aivan kuin vuorikauris väriltään.	92157	92190	jarnefelt1916a	3	33
Aivan oikein.	101851	101864	jarnefelt1916a	1	13
Aivan se nosti rintaa.	24737	24759	lassila1910a	3	22
Aivan silminnähtävästi.	163482	163505	canth1886a	1	23
Aivan veden äyräällä.	3552	3573	lehtonen1910a	2	21
Aivankuin jossain tehtaassa.	272904	272932	jarnefelt1916a	2	28
Ajat hänet täältä pois?	767524	767547	lehtonen1910a	3	23
Ajatelkaa asemaani.	28562	28581	jarnefelt1913a	1	19
Ajatteli taas sitä nenästä huomauttamistaan.	99332	99376	lassila1910a	4	44
Ajatuksissani ja tunteissani nousi suuri sekamelska.	217292	217344	jarnefelt1916a	5	52
Ajettiin, ryypittiin.	53030	53051	lassila1910a	1	21
Ajoi takaa.	627639	627650	lehtonen1910a	1	11
Ajoi, lupitti.	52202	52216	lehtonen1910a	1	14
Äkäili hiukan.	69677	69691	lehtonen1910a	1	14
Äkäinen hän on, varsinkin tuolle neidille.	604970	605012	lehtonen1910a	5	42
Älä katso sitä ihan vielä.	767210	767236	lehtonen1910a	4	26
Älä luulekaan.	98710	98724	jarnefelt1913a	1	14
Älä usko minun vihoittelevan.	162825	162854	jarnefelt1916a	3	29
Alasti.	724265	724272	lehtonen1910a	0	7
Alaveräjän raosta pujahtaa Topi saunalle.	125696	125737	lehtonen1910a	4	41
Aletut uudet puuhat tuovat painavaa huolta.	756667	756710	lehtonen1910a	5	43
Alkaa kuulla takaansa Putkinotkosta Hurjan haukuntaa.	405025	405078	lehtonen1910a	5	53
Alkaa tosissaan.	178757	178773	lehtonen1910a	1	16
Alkakaa lentää metsään.	565671	565694	lehtonen1910a	2	23
Alkoi pimetä.	39766	39779	lassila1910a	1	13
Alkuunsa se puhe jäi.	242834	242855	lehtonen1910a	3	21
Alla piilee katkeruuden myrkky.	776698	776729	lehtonen1910a	3	31
Alma ei enää seurannut hänen askareitaan.	211241	211282	canth1886a	5	41
Alma ei silmiään haudasta nostanut.	219845	219880	canth1886a	4	35
Alma ei sitä kuullut.	238686	238707	canth1886a	3	21
Alma ei.	220170	220178	canth1886a	1	8
Alma el tullut vastanneeksi.	193387	193415	canth1886a	3	28
Alma el virkkanut mitään.	168730	168755	canth1886a	3	25
Alma heittäytyi pitkäkseen, niinkuin hän tahtoi.	225624	225672	canth1886a	5	48
Alma hieman punastui.	145775	145796	canth1886a	2	21
Alma hymyili hourupäisen hymyä.	225530	225561	canth1886a	3	31
Alma istui liikkumattomana kuin haamu.	217716	217754	canth1886a	4	38
Alma käänsi ilosta hehkuvat kasvonsa sinnepäin.	100816	100863	canth1886a	5	47
Alma katseli ympärilleen.	199377	199402	canth1886a	2	25
Alma kietoi kätensä hänen kaulansa ympäri.	117871	117913	canth1886a	5	42
Alma näki sen tällä kertaa mielellään.	154428	154466	canth1886a	5	38
Alma oli kuin huumeessa.	188590	188614	canth1886a	3	24
Alma oli siitä syvästi loukkaantunut.	126290	126327	canth1886a	4	37
Alma ompeli.	127642	127654	canth1886a	1	12
Alma osoitti kädellään tyynyä.	123347	123377	canth1886a	3	30
Alma painui takaisin sijalleen.	134991	135022	canth1886a	3	31
Alma punastui.	170302	170316	canth1886a	1	14
Alma reuhasi lakkaamatta vuoteellaan.	241505	241542	canth1886a	3	37
Alma seurasi häntä tottelevaisesti sisään.	153880	153922	canth1886a	4	42
Alma tunsi itsensä hyljätyksi, yksinäiseksi.	126620	126664	canth1886a	4	44
Alma viskasi työnsä pois.	131532	131557	canth1886a	3	25
Alma yhä jatkoi edelle.	100630	100653	canth1886a	3	23
Almaa hirvitti, peloitti ja hurmasi samalla.	203784	203828	canth1886a	5	44
Almalle pysähtyi veri poveen.	190750	190779	canth1886a	3	29
Alman hätääntyneet silmät kiintyivät häneen.	212762	212806	canth1886a	4	44
Alman katse ei niihin kiintynyt.	205789	205821	canth1886a	4	32
Alman sammuva katse etsi maata.	208017	208048	canth1886a	4	31
Ammentaa rupaista vettä rotakollasta.	232427	232464	lehtonen1910a	3	37
Ammuttava olisi nuo koirat.	39345	39372	lehtonen1910a	3	27
Ananiaksella on lammessakin muutamia verkkoja.	232341	232387	lehtonen1910a	4	46
Ananiaksella täytyy olla haulikko valmiina vieressä.	394484	394536	lehtonen1910a	5	52
Ananiakselle ja Lejalle ei jäänyt mitään.	435392	435433	lehtonen1910a	5	41
Ananiakselle oli isän hankittava.	128558	128591	lehtonen1910a	3	33
Ananiakselta on työ jäänyt.	229052	229079	lehtonen1910a	3	27
Ananiakselta vaipuu vasta penkille.	717189	717224	lehtonen1910a	3	35
Ananiaksen hahmo vilahtaa saunan ohitse.	756181	756221	lehtonen1910a	4	40
Ananiaksen kanssa oltiin sieltä ruumenia hakemassa.	673395	673446	lehtonen1910a	5	51
Ananiaksen kanssa pakinoimaan.	456933	456963	lehtonen1910a	2	30
Ananiaksesta tuntuu äitelältä.	462204	462234	lehtonen1910a	2	30
Ananias ehtii isänsä luokse.	527371	527399	lehtonen1910a	3	28
Ananias huokaisee.	634477	634495	lehtonen1910a	1	18
Ananias ja Kypenäinen näkyvät siellä soutavan.	658371	658417	lehtonen1910a	5	46
Ananias ja Maunokin nauravat.	752406	752435	lehtonen1910a	3	29
Ananias juttelee hiljaisesti Maunolle.	688301	688339	lehtonen1910a	3	38
Ananias katselee häntä takaa.	524140	524169	lehtonen1910a	3	29
Ananias kompuroi kivistöllä.	796139	796167	lehtonen1910a	2	28
Ananias lähtee saunasta.	720253	720277	lehtonen1910a	2	24
Ananias ne tietäisi.	175413	175433	lehtonen1910a	2	20
Ananias on mennyt miesten aittaan.	444111	444145	lehtonen1910a	4	34
Ananias osaa yhtä paljon kuin Saara.	135823	135859	lehtonen1910a	5	36
Ananias ottaa orrelta pyssynsä.	754896	754927	lehtonen1910a	3	31
Ananias perästä.	523453	523469	lehtonen1910a	1	16
Ananias raapaisee tulta ja katsoo.	754437	754471	lehtonen1910a	4	34
Ananias riisuu tamman.	634898	634920	lehtonen1910a	2	22
Ananias sanoo tulevansa ottamaan pyssynsä.	235184	235226	lehtonen1910a	4	42
Ananias seisoo naurahdellen hänen vieressään.	402197	402242	lehtonen1910a	4	45
Ananias tahtoo Topia kanssaan heittämään verkkoja.	647417	647467	lehtonen1910a	5	50
Ananias tempaa rahinjalat pois Topilta.	124695	124734	lehtonen1910a	4	39
Ananias tonkaisee rautakangella sieltä täältä.	799747	799793	lehtonen1910a	4	46
Ananias työntää hänelle ovenraosta kipan.	711091	711132	lehtonen1910a	4	41
Ananias vastaa myöntävästi.	524290	524317	lehtonen1910a	2	27
Ananiaskin yhtenä kesänä otti kiinni ukkometson.	173447	173495	lehtonen1910a	5	48
Ananiasko nyt pitikin ottaa?	155982	156010	lehtonen1910a	3	28
Ananiasta Lejan jutut kiusaavat.	461980	462012	lehtonen1910a	3	32
Ananiasta pyörryttää.	717303	717324	lehtonen1910a	1	21
Angervoista käy väkevä tuoksu.	583207	583237	lehtonen1910a	3	30
Ankarasti: Mine on sööny.	96703	96728	jarnefelt1913a	3	25
Anna huutaa.	101351	101363	lehtonen1910a	1	12
Anna Kaisa alkoi hääräillä kahvinkeittopuuhissa.	29011	29059	lassila1910a	4	48
Anna Kaisa näytti syventyvän työhönsä.	28199	28237	lassila1910a	4	38
Anna Liisa hätäytyi ja uudisti kysymyksensä.	198011	198055	lassila1910a	5	44
Anna Liisa itki pariin kertaan.	99090	99121	lassila1910a	4	31
Anna Liisalle paljastui Antin kataluus.	255136	255175	lassila1910a	4	39
Anna Liisan mieltä kaiveli surulliset asiat.	200914	200958	lassila1910a	5	44
Anna minulle anteeksi, olenhan sinun omasi.	134672	134715	canth1886a	5	43
Annetaan Juudaksen olla.	44148	44172	jarnefelt1913a	2	24
Anni kirkui, Petu tuuditti ja lauloi.	39023	39060	canth1886a	5	37
Antaa heille ne anteeksi, unohtaa.	290714	290748	lehtonen1910a	4	34
Antaa kaikki selvitä samalla.	224710	224739	canth1886a	3	29
Antaa kirjeen Tyynelle.	94625	94648	jarnefelt1913a	2	23
Antaa sen kehittyä luonnollisesti, vähitellen.	107490	107536	canth1886a	4	46
Antilla oli mainio ruokahalu.	31011	31040	lassila1910a	3	29
Antin päätä alkoi pahemmin pakottaa.	60880	60916	lassila1910a	4	36
Antin tuli yhä vaikeampi olla.	276963	276993	lassila1910a	4	30
Antinous ajattelee, käsi otsallansa.	34360	34396	kilpi1903a	3	36
Antinous ajattelee.	33941	33960	kilpi1903a	1	19
Antinous katsoo kuin jäykistyvänä ympärilleen.	96922	96968	kilpi1903a	4	46
Antinous käyskelee ja mielensä seestyy.	26140	26179	kilpi1903a	4	39
Antoi meillekin.	651784	651800	lehtonen1910a	1	16
Anton ja Tyyni kohauttavat toisilleen olkapäätä.	105196	105244	jarnefelt1913a	5	48
Anton Leander jää liikahtamatta paikoilleen.	115192	115236	jarnefelt1913a	4	44
Antta se ny olla viimene kertta.	100452	100484	jarnefelt1913a	5	32
Antti istui vielä hetken ja hikosi.	279350	279385	lassila1910a	5	35
Antti jouti nyt hautomaan ajatuksiansa.	51197	51236	lassila1910a	4	39
Antti näytti nukahtavan.	229485	229509	lassila1910a	2	24
Antti oli jo heittää koko yrityksen.	22540	22576	lassila1910a	5	36
Antti oli nyt hyvin miettivä.	275119	275148	lassila1910a	4	29
Antti totteli.	43737	43751	lassila1910a	1	14
Antti vain mulautti silmiänsä.	280740	280770	lassila1910a	3	30
Anttia painoi kuin suuri kivi.	276571	276601	lassila1910a	4	30
Aprikoimaan asian ihan selväksi.	98381	98413	lehtonen1910a	3	32
Apteekkari katsoo kattoon.	276532	276558	lehtonen1910a	2	26
Apteekkiin tulee taas lisää väkeä.	279175	279209	lehtonen1910a	4	34
Apulaiset ovat nyt huoneen takaosassa.	276787	276825	lehtonen1910a	4	38
Är du från dina sinnen?	101664	101687	jarnefelt1913a	4	23
Arvasinhan minä.	212045	212061	lehtonen1910a	1	16
Arveli, ettei John häntä ymmärtänyt.	117321	117357	canth1886a	4	36
Arvelihan se Antti osaavansa.	177711	177740	lassila1910a	3	29
Arvi hengitti huohottaen ja ruumis poltti.	208213	208255	canth1886a	5	42
Arvin jalat ja kädet olivat kylmät.	216921	216956	canth1886a	5	35
Arvokas lahja, joka oli riemastuttava äidin.	330	374	pakkala1895a	5	44
Asetun vaan mukavammin, kas näin.	146023	146056	jarnefelt1913a	4	33
Asia alkoi miellyttää.	261306	261328	lassila1910a	2	22
Asia näytti entisestäänkin yhä vain pahenevan.	141261	141307	lassila1910a	5	46
Asia näytti luistavan.	28018	28040	lassila1910a	2	22
Asia näytti rupeavan luistamaan itsestänsä.	17539	17582	lassila1910a	4	43
Asia näyttikin jo siihen unohtuvan.	9661	9696	lassila1910a	4	35
Asia oli sitä myöten selvä.	104632	104659	lassila1910a	4	27
Äskeinen rauhattomuus hänet valtasi jälleen.	187287	187331	canth1886a	4	44
Äskeisellä nuotilla laulaa hän uutta laulua.	70727	70771	lehtonen1910a	5	44
Äsken juuri viimeksi.	191193	191214	canth1886a	2	21
Astia oli täpösen täynnä mustanruskeita kahvinpapuja.	30424	30477	pakkala1895a	5	53
Astun lyhyin askelin, alleni tuijottaen.	126173	126213	jarnefelt1913a	4	40
Aterialla puheltiin talon myömisestä.	249470	249507	lassila1910a	3	37
Auringon kuva häikäisee vedestä.	181051	181083	lehtonen1910a	3	32
Auringonsäteet eivät koskaan pääse sinne syvyyksiin.	3342	3394	lehtonen1910a	5	52
Aurinko alenee punertavan pajupensaikon takana.	626272	626319	lehtonen1910a	4	47
Aurinko jo laskehti, oli illallisen aika.	132647	132688	canth1886a	5	41
Aurinko läikehtii lempeästi.	585084	585112	lehtonen1910a	2	28
Aurinko lämmittää vielä.	624851	624875	lehtonen1910a	2	24
Aurinko laskee.	650729	650744	lehtonen1910a	1	15
Aurinko oli silloin jo mennyt mailleen.	213152	213191	jarnefelt1916a	5	39
Aurinko paistaa sinne.	197970	197992	lehtonen1910a	2	22
Aurinko paistaa.	189922	189938	lehtonen1910a	1	16
Aurinko syleilee häntä valtoinaan.	2199	2233	jarnefelt1913a	3	34
Auttakaa, auttakaa minua, rukoilin minä lääkäriä.	25379	25428	jarnefelt1913a	5	49
Auttamaan pikku Esteriä.	544738	544762	lehtonen1910a	2	24
Avaa yhden kirjeistä.	94572	94593	jarnefelt1913a	2	21
Avaimetta pysyy ovi ikuisesti suljettuna.	3325	3366	jarnefelt1916a	4	41
Avain ei kyllä ole sen kummempi.	2953	2985	jarnefelt1916a	5	32
Avonaisista ovista hengähtelee kesäisen illan ilma.	658899	658950	lehtonen1910a	5	51
Äyskäri käy yhtenä kiekkona.	164656	164684	lehtonen1910a	3	28
Browningkuula ohimoon.	123719	123741	jarnefelt1916a	1	22
Edellinen on jonkun poikalapsen, jälkimmäinen tytön.	21738	21790	lehtonen1910a	5	52
Edes jostakin, hän, erillään eläjä.	241744	241779	lehtonen1910a	4	35
Eeva sai Jaakon innostumaan.	5803	5831	pakkala1895a	3	28
Eevan nukke sai kärsiä koston.	3873	3903	pakkala1895a	4	30
Eevasta se oli erinomaista ja mukavaa.	5658	5696	pakkala1895a	5	38
Ehkä ei tarvinnutkaan Jumalalle antaa marjoja.	86683	86729	pakkala1895a	5	46
Ehkä Kalle oli sittenkin oikeassa.	86730	86764	pakkala1895a	4	34
Ehkä loppui kaikki siihen?	236903	236929	canth1886a	3	26
Ehkä ne esteet ovat tunteissa.	165840	165870	jarnefelt1916a	4	30
Ehkä se ei tulekaan enää takaisin.	292802	292836	lehtonen1910a	5	34
Ehkei Mauno ole häntä ennättänyt yllyttää?	562897	562939	lehtonen1910a	5	42
Ei ainoata sanaa kaipauksesta, erosta, ikävästä.	126224	126272	canth1886a	5	48
Ei auttanut muu kuin päätellä sisällöstä.	139415	139456	jarnefelt1916a	5	41
Ei enää epäilystäkään.	24179	24201	jarnefelt1913a	2	22
Ei ensin näe mitään.	652185	652205	lehtonen1910a	3	20
Ei erota, kuka mitäkin huutaa.	642296	642326	lehtonen1910a	4	30
Ei hän muka tarvinnut Könösen jauhoja.	97397	97435	lehtonen1910a	5	38
Ei hän niin pian tuvasta pääse.	156373	156404	lehtonen1910a	5	31
Ei hän niinkään pystymätön ole.	170387	170418	lehtonen1910a	4	31
Ei hän olisi Maunoa kadehtinut.	502783	502814	lehtonen1910a	4	31
Ei hän paljoa ymmärrä.	771381	771403	lehtonen1910a	3	22
Ei hän pelosta siellä niityllä ole.	635599	635634	lehtonen1910a	5	35
Ei hän sinne lähde.	106443	106462	lehtonen1910a	3	19
Ei hän sitä nytkään tiedä.	500931	500957	lehtonen1910a	4	26
Ei hän sitäkään kuule.	130981	131003	jarnefelt1913a	3	22
Ei hänellä ollut muita.	774823	774846	lehtonen1910a	3	23
Ei herrasväkeä, eikä varsinkaan ylpeitä talonpoikia.	429604	429656	lehtonen1910a	5	52
Ei Käkriäinen muista oikein sanoja.	504605	504640	lehtonen1910a	4	35
Ei kauluksia, tuota korvettavan tornia.	575807	575846	lehtonen1910a	4	39
Ei kestäisi enää puoleksikaan niinkuin silloin.	17552	17599	canth1886a	5	47
Ei kuitenkaan ollut aivan varma siitä.	549205	549243	lehtonen1910a	5	38
Ei kukaan vastannut Anna Liisalle.	197845	197879	lassila1910a	4	34
Ei kun kangella pääkuoreen vaan.	211273	211305	lehtonen1910a	4	32
Ei kuukka tietemä.	114776	114794	jarnefelt1913a	2	18
Ei kuulu ääntä.	200581	200596	lehtonen1910a	2	15
Ei kuulu kelloja eikä lehmien ammumista.	45006	45046	lehtonen1910a	5	40
Ei kuulu vastausta.	384858	384877	lehtonen1910a	2	19
Ei kuulu vastausta.	488377	488396	lehtonen1910a	2	19
Ei lyhyeen tuokioon.	741242	741262	lehtonen1910a	2	20
Ei me olla sinun housujesi vaivaisia.	622605	622642	lehtonen1910a	5	37
Ei mikään, ei mikään auttanut.	22430	22460	jarnefelt1916a	4	30
Ei mitään mielenkiintoista.	1405	1432	jarnefelt1913a	2	27
Ei mitään, ei kerrassa mitään.	69817	69847	canth1886a	4	30
Ei mitään, joka toisi mieleen surua.	325491	325527	lehtonen1910a	5	36
Ei mitkään kyynelvirrat tehtyä tekemättömäksi saaneet.	238899	238953	canth1886a	5	54
Ei näe eteensä hieltä ja kärpäsiltä.	382517	382553	lehtonen1910a	5	36
Ei näe siivota marjoja, niin sanoo.	512350	512385	lehtonen1910a	5	35
Ei näkynyt eikä kuulunut ketään.	24202	24234	canth1886a	4	32
Ei näkynyt marjanvarsiakaan.	94859	94887	pakkala1895a	2	28
Ei näy missään.	174205	174220	lehtonen1910a	2	15
Ei näy, mistä siihen pääsisi ylös.	796474	796508	lehtonen1910a	5	34
Ei näy.	421213	421220	lehtonen1910a	1	7
Ei niistä oikean ihmisen maha täyty.	111596	111632	lehtonen1910a	5	36
Ei niitä puita enää paljoa tarvitakaan.	655577	655616	lehtonen1910a	5	39
Ei nyt.	81930	81937	jarnefelt1916a	1	7
Ei ole lähellä ketään.	274389	274411	lehtonen1910a	3	22
Ei ole niin kipeä enää.	630258	630281	lehtonen1910a	4	23
Ei ole sinun varassasi.	491689	491712	lehtonen1910a	3	23
Ei ole tuonut kuin muutamia puita.	299747	299781	lehtonen1910a	5	34
Ei ole.	368371	368378	lehtonen1910a	1	7
Ei ollut kerrassaan mitään neuvoa.	77572	77606	pakkala1895a	4	34
Ei ollut muita kuin Esteri huoneessa.	4972	5009	pakkala1895a	5	37
Ei ollut oikeastaan halua mihinkään.	7966	8002	pakkala1895a	4	36
Ei ollut puhunut juuri mitään.	508581	508611	lehtonen1910a	4	30
Ei ollut puhunutkaan paljoa.	549867	549895	lehtonen1910a	3	28
Ei ollut uskaltanut tulla pihalle.	561419	561453	lehtonen1910a	4	34
Ei ollut varaa laittaa.	42983	43006	pakkala1895a	3	23
Ei pässi kukkaroihinsa rahaa tarvitse.	432089	432127	lehtonen1910a	4	38
Ei pelottanut ollenkaan.	35251	35275	pakkala1895a	2	24
Ei puhunut silloin mitään.	520147	520173	lehtonen1910a	3	26
Ei risahdusta eikä ääntä.	205700	205725	canth1886a	3	25
Ei saa katsoa.	602470	602484	lehtonen1910a	2	14
Ei sano Muttinen mitään.	564566	564590	lehtonen1910a	3	24
Ei sanonut.	61404	61415	pakkala1895a	1	11
Ei se kierrä ketään.	139973	139993	lassila1910a	3	20
Ei se köyhemmille ainakaan, tietääkseni.	349532	349572	lehtonen1910a	4	40
Ei se kumminkaan, vanhaa ystävää.	431204	431237	lehtonen1910a	4	33
Ei se Makkos-vainajakaan milloinkaan velkakauppaa tehnyt.	213879	213936	lassila1910a	5	57
Ei se Malakias olekaan tyhjentänyt venettä.	153747	153790	lehtonen1910a	5	43
Ei se sellainen se rouva.	595350	595375	lehtonen1910a	4	25
Ei sieltä tule muita kuin Sanelma.	311104	311138	lehtonen1910a	5	34
Ei siis tavottanut heitä.	62039	62064	jarnefelt1913a	3	25
Ei siitä ollut yrittääkään.	80073	80100	pakkala1895a	3	27
Ei sillä niin pieni jalka ole.	133079	133109	lehtonen1910a	5	30
Ei silloin paleltanut, sellainen on.	520049	520085	lehtonen1910a	4	36
Ei sitä löydy aitasta mistään.	107029	107059	lehtonen1910a	4	30
Ei sittenkään huolittu vastata.	72500	72531	jarnefelt1916a	3	31
Ei sittenkään.	35436	35450	canth1886a	1	14
Ei sovi nyt puhua kielillä.	451215	451242	lehtonen1910a	4	27
Ei suostunut Maija Liisa.	95252	95277	lassila1910a	3	25
Ei tahtonut ehtiäkään tehdä.	74900	74928	lassila1910a	3	28
Ei tahtonut enää keksiä mistä alkaa.	129039	129075	lassila1910a	5	36
Ei tämä mökki ole Maunon oma.	292656	292685	lehtonen1910a	5	29
Ei tarvitsisi tätä Muttisenkaan muualta kuljetella.	209315	209366	lehtonen1910a	5	51
Ei tuosta heinänteostakaan.	236258	236285	lehtonen1910a	2	27
Ei vai, raiskalla.	248529	248547	lehtonen1910a	2	18
Ei vara vahingoksi.	708342	708361	lehtonen1910a	2	19
Ei vastannut mitään.	178743	178763	canth1886a	2	20
Ei vastausta.	153610	153623	lehtonen1910a	1	13
Ei vastausta.	385079	385092	lehtonen1910a	1	13
Ei vieläkään vastausta.	789493	789516	lehtonen1910a	2	23
Ei yhtikäs mikään.	182510	182528	canth1886a	2	18
Ei, ei aijotko sisääni tunkeutua?	41066	41099	jarnefelt1913a	4	33
Ei, ei ollut neidistäkään Rosinalle apua.	756798	756839	lehtonen1910a	5	41
Ei, ei tahtoisi Rosina niitä lisää.	742969	743004	lehtonen1910a	5	35
Ei, ei, vika on minussa.	266490	266514	jarnefelt1916a	4	24
Ei, hän ei tahtonut häiritä.	155097	155125	canth1886a	4	28
Ei, hiljaa oli Topi ystäväänsä huudellut.	165199	165240	lehtonen1910a	5	41
Ei, johonkin täytyy saada rouhaista kiinni.	386246	386289	lehtonen1910a	5	43
Ei, loppu tästä täytyy tulla.	599728	599757	lehtonen1910a	4	29
Ei, lukijani.	120130	120143	jarnefelt1916a	1	13
Ei, makaa, röhöttää silloin kuukausittain.	47699	47741	lehtonen1910a	4	42
Ei, minä en jaksa tätä.	780329	780352	lehtonen1910a	4	23
Ei, rakkaitahan ovat lapset, Jumalan lahjat.	53624	53668	lehtonen1910a	5	44
Ei, sanoin väärin.	123140	123158	jarnefelt1916a	2	18
Ei, selinpäs kääntyy Muttinen Perttaan.	547931	547970	lehtonen1910a	4	39
Ei, syy on tämmöinen.	154256	154277	jarnefelt1916a	3	21
Ei, tuleen vain Putkinotko.	504407	504434	lehtonen1910a	3	27
Eihän John siitä välitä, ajatteli hän.	146636	146674	canth1886a	5	38
Eihän Jöijellä ole ollut käsitystäkään uimisesta.	87372	87421	jarnefelt1916a	5	49
Eihän miestä mitata hatulla.	488963	488991	lehtonen1910a	3	28
Eihän se vanhan pää tällaista kestä.	728397	728433	lehtonen1910a	5	36
Eihän siitä soutamisesta mitään tullut.	69143	69182	jarnefelt1916a	4	39
Eihän sillä ennen sellaista ollut.	529347	529381	lehtonen1910a	4	34
Eihän sinne tupakatta.	704792	704814	lehtonen1910a	2	22
Eihän sitä metsäsikaa ollutkaan.	396427	396459	lehtonen1910a	3	32
Eihän tuota näy pihalla.	430325	430349	lehtonen1910a	3	24
Eikä antanut eukkonsakaan hankkia.	19133	19167	lehtonen1910a	3	34
Eikä auta.	233008	233018	canth1886a	1	10
Eikä avattua raamattua pöydän päässä telineellä.	770749	770797	lehtonen1910a	5	48
Eikä enää syökään.	631910	631928	lehtonen1910a	2	18
Eikä hän kiihdy milloinkaan.	304770	304798	lehtonen1910a	3	28
Eikä hän niitä poliisejakaan pelkää.	187036	187072	lehtonen1910a	4	36
Eikä hän oikein näe polkuakaan.	378293	378324	lehtonen1910a	4	31
Eikä hän pääse mukaan, vaikka tahtoo.	234436	234473	lehtonen1910a	5	37
Eikä hän pelkää niitä paljainkaan jaloin.	211001	211042	lehtonen1910a	5	41
Eikä hän silloin joutaisi kotiinkaan heinäntekoon.	360692	360742	lehtonen1910a	5	50
Eikä hän sitä ole salannutkaan ihmisiltä.	321270	321311	lehtonen1910a	5	41
Eikä hän sitä vatia siellä odottanut.	734139	734176	lehtonen1910a	5	37
Eikä hän usein pääsekään.	48524	48549	lehtonen1910a	3	25
Eikä häneltä suinkaan udella.	655276	655305	lehtonen1910a	3	29
Eikä itku tahtonut salpautuakaan.	113076	113109	pakkala1895a	3	33
Eikä itse niitä viljele, antaa metsittyä.	453166	453207	lehtonen1910a	5	41
Eikä John tullut häntä katsomaan.	132169	132202	canth1886a	4	33
Eikä Käkriäisen Juutasta siepattu kiinni.	94827	94868	lehtonen1910a	4	41
Eikä kiroilekaan.	547832	547849	lehtonen1910a	1	17
Eikä kukaan häntä auta.	745333	745356	lehtonen1910a	3	23
Eikä kukaan mitään epäillyt.	67214	67242	jarnefelt1913a	3	28
Eikä kuule kanan laulua.	19445	19469	lehtonen1910a	3	24
Eikä Leja ole ruvennut valhettelemaan.	236450	236488	lehtonen1910a	4	38
Eikä minua nukuta lainkaan.	182281	182308	canth1886a	3	27
Eikä ne olisi auttaneet.	238874	238898	canth1886a	3	24
Eikä neiti antanutkaan itseään houkutella.	549277	549319	lehtonen1910a	4	42
Eikä ollut paljon hihojakaan.	249577	249606	lehtonen1910a	3	29
Eikä oppilaskaan, vaan kuitenkin tuo farmaseutti.	277662	277711	lehtonen1910a	5	49
Eikä pelasta kukaan.	232987	233007	canth1886a	2	20
Eikä pidä hätäillä.	195875	195894	lehtonen1910a	2	19
Eikä Rosinalla ole nytkään rahaa.	109035	109068	lehtonen1910a	4	33
Eikä se ole.	65007	65019	lehtonen1910a	2	12
Eikä se olekaan siellä.	306774	306797	lehtonen1910a	3	23
Eikä se tohtorin juomilla, sellainen.	714744	714781	lehtonen1910a	4	37
Eikä se yrittänytkään.	429280	429302	lehtonen1910a	2	22
Eikä siitä matkasta tahtonut mitään tulla.	56859	56901	lehtonen1910a	5	42
Eikä siitä niin kauan tuntunut olevankaan.	127974	128016	pakkala1895a	5	42
Eikä tänne hevillä teitä saataisikaan.	782245	782283	lehtonen1910a	4	38
Eikä tuo tosiaan vielä väsytäkään.	372514	372548	lehtonen1910a	4	34
Eikä varsinkaan se teräväsilmäinen neiti.	638553	638594	lehtonen1910a	4	41
Eikä vastaa Svean kysymyksiin.	361073	361103	lehtonen1910a	3	30
Eikä viitsi ottaa lakkiakaan päästänsä.	49536	49575	lehtonen1910a	4	39
Eikä Ville voinut itseäänkään vakuuttaa.	15072	15112	pakkala1895a	4	40
Eikähän Ananiaksella olekaan pyssyä.	795903	795939	lehtonen1910a	3	36
Eikähän minusta ollut häntä opettamaan.	779399	779438	lehtonen1910a	4	39
Eikähän se aivan ainoa syy ollutkaan.	156377	156414	canth1886a	5	37
Eikähän se kaikille uskallakaan.	448236	448268	lehtonen1910a	3	32
Eikö hänen olisi sittenkään pitänyt tuomita?	46318	46362	jarnefelt1913a	5	44
Eikö ihminenkin hetkinään liiku rajattomana?	90404	90448	kilpi1903a	4	44
Eikö ihmisessäkin ole rajaton elämä?	90367	90403	kilpi1903a	4	36
Eikö niille kukaan siitä mahda mitään?	735916	735954	lehtonen1910a	5	38
Eikö nyt enää Zolakaan ole rauhoitettu.	141444	141483	canth1886a	5	39
Eikö ole kassaraa?	566602	566620	lehtonen1910a	2	18
Eikö ole yhdentekevää milloin?	152535	152565	jarnefelt1913a	3	30
Eikö ottanut hovilaisten härästä?	427105	427138	lehtonen1910a	3	33
Eikö saa olla vielä teetä?	108154	108180	jarnefelt1913a	4	26
Eikö se Juutas sieltä jo tule?	73408	73438	lehtonen1910a	5	30
Eikö se merkitse jag fånades?	160973	161002	jarnefelt1916a	4	29
Eikö se muka nytkään tahtoisi.	427157	427187	lehtonen1910a	4	30
Eikö se ole ätläkkää syödä, sellainen?	602810	602848	lehtonen1910a	5	38
Eikö se pömpötti herkeä pörisemästä?	210416	210452	lehtonen1910a	4	36
Eikö se siellä ollut?	155274	155295	lehtonen1910a	3	21
Eikö sillä ollut se keltainen hännänpää?	212070	212110	lehtonen1910a	5	40
Eikö sinun nauriisi ole edellä?	409695	409726	lehtonen1910a	4	31
Eikö sitä olisi veden kantamista saunaan?	645062	645103	lehtonen1910a	5	41
Eikö sitten ole vanha?	784639	784661	lehtonen1910a	3	22
Eikö teitä inhota ulkokultaiset pappilanneidit?	228720	228767	jarnefelt1916a	4	47
Eikö voisi keittää niistä jauhoista?	310172	310208	lehtonen1910a	4	36
Eiköhän tulisi hätä niinkuin kesälläkin.	4744	4784	pakkala1895a	4	40
Eikös Ananiaskin tule saunaan?	694533	694563	lehtonen1910a	3	30
Eikös noista nyt saa kalua millään.	515337	515372	lehtonen1910a	5	35
Eikös se nyt nuku?	520630	520648	lehtonen1910a	3	18
Eikös se uni nyt tule?	520939	520961	lehtonen1910a	4	22
Eikös sekin jo savua tupruttele?	555751	555783	lehtonen1910a	4	32
Eikös tunkeutunut tänäkin kesänä tänne, Muttinen.	545653	545702	lehtonen1910a	5	49
Eipä enää kymmeniin vuosiin.	321312	321340	lehtonen1910a	3	28
Eipä mahdukaan hänen hattunsa ovesta.	598042	598079	lehtonen1910a	4	37
Eipä Saara niistä terveisistä välittänyt.	570654	570695	lehtonen1910a	4	41
Eivät Hamsunia, sanahumpuukin sumua silmille.	766929	766974	lehtonen1910a	4	45
Eivät he lopulta ymmärtäneet toisiaan.	589457	589495	lehtonen1910a	4	38
Eivät he paljoa tiedä eivätkä taida.	782615	782651	lehtonen1910a	5	36
Eivät ihmiset unohda.	391761	391782	lehtonen1910a	2	21
Eivät kaikki olleet sentään hylänneet meitä.	146142	146186	jarnefelt1916a	5	44
Eivät ne ole heinänteossa.	384949	384975	lehtonen1910a	3	26
Eivät ne taida kuulua niityltäkään.	318969	319004	lehtonen1910a	4	35
Eivät ota.	234037	234047	lehtonen1910a	1	10
Eivät vai?	712821	712831	lehtonen1910a	1	10
Eiväthän nämä sellaisesta vähäisestä kävelystä kuluneet.	134631	134687	lehtonen1910a	5	56
Eivätkä aivoni humallu edes parhaasta malagasta.	781210	781258	lehtonen1910a	5	48
Eivätkä he raja-aidoista välitäkään.	607399	607435	lehtonen1910a	3	36
Eivätkä kaalit täytä mahaa.	207894	207921	lehtonen1910a	3	27
Eivätkä ne vieraat olleetkaan hänelle tuttuja.	343655	343701	lehtonen1910a	5	46
Eivätkä sitä akat saakaan kiinni.	525280	525313	lehtonen1910a	4	33
Eivätkä sormet soutaessa avaudu, eivät sulkeudu.	179112	179160	lehtonen1910a	5	48
Eksyy jotenkin toisista.	97796	97820	pakkala1895a	2	24
Elämä alkoi vaatia omaansa.	206251	206278	lassila1910a	3	27
Elämä oli tässä meidän toveruutemme uhmassa.	58620	58664	jarnefelt1913a	5	44
Elämä, ulkopuolinen, kolea hantela elämä?	75778	75819	kilpi1903a	4	41
Elämänijän?	184556	184567	canth1886a	0	11
Eläviä käärmeitä.	255768	255785	lehtonen1910a	1	17
Elettävähän senkin oli.	333083	333106	lehtonen1910a	2	23
Ella, näet, oli hänen lempilapsensa.	128823	128859	canth1886a	4	36
Ellen erehdy, häntä melkein nukutti.	42823	42859	jarnefelt1916a	4	36
Eloviljoistahan kaikki elävät.	2505	2535	jarnefelt1916a	2	30
Elsa ei osannut selittää.	39103	39128	pakkala1895a	3	25
Elsa istui ikkunan ääressä katsellen ulos.	38542	38584	pakkala1895a	5	42
Elsasta tuntui, että se murisi.	43605	43636	pakkala1895a	4	31
Elukkeet halkeavat ja kuolevat.	344688	344719	lehtonen1910a	3	31
Emännät puhuivat välillä kehruuksista.	9697	9735	lassila1910a	3	38
Emännöitsijä lähettikin moottorin kaupunkiin.	348281	348326	lehtonen1910a	3	45
Emännöitsijä on myöskin joutunut paikalle.	363251	363293	lehtonen1910a	4	42
Emännöitsijä touhusi karjapihalla.	348443	348477	lehtonen1910a	2	34
Emme olleet kumpikaan.	292887	292909	jarnefelt1916a	2	22
En huolinut heitä herättää.	212726	212753	lehtonen1910a	3	27
En jaksa enää.	154018	154032	jarnefelt1913a	2	14
En käsitä mitään.	175777	175794	canth1886a	2	17
En minä ilmaise, olkaa huoletta.	110325	110357	jarnefelt1913a	4	32
En ole koskaan voinut olla toimetonna.	31021	31059	jarnefelt1913a	5	38
En ole tehnyt.	227363	227377	lehtonen1910a	2	14
En olisi voinut aavistaa.	92220	92245	jarnefelt1916a	3	25
En pakosta, vaan ihmisen vapaasta tahdosta.	776605	776648	lehtonen1910a	5	43
En präktig författarinna.	97813	97838	jarnefelt1913a	2	25
En rupea.	311521	311530	lehtonen1910a	1	9
En saanut häntä parhaillakaan pyynnöillä istahtamaan.	34139	34192	jarnefelt1916a	5	53
En tahtonut ollenkaan selviytyä.	273130	273162	jarnefelt1916a	3	32
En tiedä.	784817	784826	lehtonen1910a	1	9
En tiedä.	18682	18691	jarnefelt1913a	1	9
En tiennyt purskahtaako nauruun vai vihastua.	227158	227203	jarnefelt1916a	5	45
En tuota nyt satu muistamaan.	355107	355136	lehtonen1910a	4	29
En uskaltanut jatkaa.	44435	44456	jarnefelt1916a	2	21
En usko.	172925	172933	jarnefelt1916a	1	8
En vaikka tarjoaisivat mitä.	461246	461274	lehtonen1910a	3	28
En voi korviani, en silmiäni uskoa.	185571	185606	jarnefelt1916a	5	35
En voinut lukea etemmäs.	123851	123875	jarnefelt1916a	3	24
Enempää ei Rosina tahtonut kuulla.	742340	742374	lehtonen1910a	4	34
Enimmin kuitenkin painoi se Vatasen naimisasia.	276359	276406	lassila1910a	5	47
Enkä minä heistä sen enempää.	213428	213457	lehtonen1910a	4	29
Enkö enää saa lohduttaakaan, ajattelin.	287339	287378	jarnefelt1916a	4	39
Enkö ole sitä sanonut.	36453	36475	jarnefelt1913a	3	22
Ennen kuolema ja kurjuus.	506513	506538	lehtonen1910a	3	25
Ennen siitä sai.	633765	633781	lehtonen1910a	2	16
Ennustusko se oli vai mikä?	51186	51213	canth1886a	4	27
Ensi katsauksesta, ensi kädenlyömästä sen tunsin.	13548	13597	jarnefelt1913a	5	49
Ensi kirjeessä koetan korjata ajattelemattomuuteni.	163473	163524	jarnefelt1916a	4	51
Ensi silmäyksellä hän käsitti asian laidan.	79389	79432	canth1886a	5	43
Ensiksikin hän kertoo asian juurtajaksaen.	168690	168732	lassila1910a	4	42
Ensiksikin välttämättä kaunis.	113280	113310	canth1886a	2	30
Ensimmäiselle miehelle sai kolme lasta.	296923	296962	lehtonen1910a	4	39
Ensin kertoi siitä helpottaakseen mieltään.	321366	321409	lehtonen1910a	4	43
Ensin näytti niin ruskealta ja pieneltä.	174341	174381	lehtonen1910a	5	40
Ensin papin luokse, sitten lääkärin.	78876	78912	canth1886a	4	36
Ensin se murisi siitäkin, takavuosina.	690706	690744	lehtonen1910a	4	38
Ensin toisella etujalallani, sitten toisellakin.	126014	126062	jarnefelt1913a	4	48
Ensin tuntui tuo renkutus hirmuisen typerältä.	56610	56656	jarnefelt1913a	5	46
Entä ihmisiä.	506889	506902	lehtonen1910a	1	13
Entä kun nyt harjoittelisit, muruseni, siihen.	178595	178641	canth1886a	5	46
Entä sisämaa?	3775	3788	lehtonen1910a	1	13
Entä tuo punastuminen?	119433	119455	jarnefelt1916a	2	22
Entäpä Juutaksen isot ja latuskaiset jalkaterät?	369477	369525	lehtonen1910a	5	48
Entäs junttapiimää?	280779	280798	lehtonen1910a	1	19
Entäs juutalaisen piritystä?	280585	280613	lehtonen1910a	2	28
Entäs kirpun siemeniä?	280683	280705	lehtonen1910a	2	22
Entäs krepkoita votkaa?	280819	280842	lehtonen1910a	2	23
Entäs kurkmeijaa?	280665	280682	lehtonen1910a	1	17
Entäs Topi, ja Saara?	76157	76178	lehtonen1910a	3	21
Entäs Topi?	204304	204315	lehtonen1910a	1	11
Epäävän vastauksen hän sai.	22697	22724	canth1886a	3	27
Epätoivon vallassa.	296775	296794	lehtonen1910a	1	19
Erämaa kuistin ympärillä tumma.	760496	760527	lehtonen1910a	3	31
Erehdys.	138665	138673	jarnefelt1916a	0	8
Ester auttaa Repekan sinne.	235852	235879	lehtonen1910a	3	27
Ester jää paljasmahaisen Repekan taluttajaksi.	398942	398988	lehtonen1910a	4	46
Ester pitää häntä lattialta käsin kiinni.	515677	515718	lehtonen1910a	5	41
Ester tulee Jopin luokse siivosti.	434185	434219	lehtonen1910a	4	34
Ester tulee repaleisessa mekossaan.	553913	553948	lehtonen1910a	3	35
Et rupea?	488713	488722	lehtonen1910a	1	9
Et sinä tiedäkään.	217317	217335	lehtonen1910a	2	18
Et usko kuinka yhteinen työ ystävystyttää.	273777	273819	jarnefelt1916a	5	42
Eteenpäin käveli; tie tuntui tavallista pitemmältä.	16760	16811	canth1886a	5	51
Ethän aio ajaa heitä pois?	781474	781500	lehtonen1910a	4	26
Ethän?	767486	767492	lehtonen1910a	0	6
Etkö mene?	82750	82760	lehtonen1910a	1	10
Etkö muka mene?	83303	83318	lehtonen1910a	2	15
Etkö näytä sitä vieläkään?	763746	763772	lehtonen1910a	3	26
Etkö voi hymähtää?	157972	157990	jarnefelt1913a	2	18
Etkös sinä?	517291	517302	lehtonen1910a	1	11
Että maailma on pallo.	359443	359465	lehtonen1910a	3	22
Että saadaan paistaa leivät.	522072	522100	lehtonen1910a	3	28
Että saisi olla rauhassa, yksin.	112564	112596	lehtonen1910a	4	32
Että saisimme olla ja syödä rauhassa.	597828	597865	lehtonen1910a	5	37
Että toivomukseni saivat pitkän nenän.	772882	772920	lehtonen1910a	4	38
Että vaan kaikki näkisivät, välttämättä kaikki.	11527	11574	jarnefelt1913a	5	47
Ette jaksaneet.	148819	148834	jarnefelt1913a	1	15
Ettehän te niitä tahallanne meille?	357382	357417	lehtonen1910a	4	35
Ettei hän vaan menettäisi järkeään.	57549	57584	canth1886a	4	35
Etteivät ne tapata vielä muitakin lehmiä.	377847	377888	lehtonen1910a	5	41
Ettekö tunne?	140226	140239	canth1886a	1	13
Evästän hänet Muttisen luokse.	493409	493439	lehtonen1910a	3	30
Forsman oli ällistynyt.	152147	152170	lassila1910a	2	23
Fsjoravno, nu?	104789	104803	jarnefelt1913a	1	14
God afton, god afton, söta du.	93623	93653	jarnefelt1913a	5	30
Häähame on hänellä parhaana.	489169	489197	lehtonen1910a	3	28
Haastatko sinä hänet käräjiin?	767493	767523	lehtonen1910a	3	30
Haha, kolmisormen linjamenttiä.	279627	279658	lehtonen1910a	2	31
Hähhäh.	488723	488730	lehtonen1910a	0	7
Hähhäh.	701931	701938	lehtonen1910a	0	7
Häilyy sinuna, Endymion.	33437	33461	kilpi1903a	2	24
Haisevansakin Käkriäinen siinä hiukan huomaa.	361534	361579	lehtonen1910a	4	45
Haisteli.	627651	627660	lehtonen1910a	0	9
Hajallaan kuin eksyneet lampaat.	534059	534091	lehtonen1910a	3	32
Häkääkö?	693579	693587	lehtonen1910a	0	8
Hakekoon, joka on avaintansa vailla.	2025	2061	jarnefelt1916a	4	36
Hälisten kaikuvat menevien äänet tuvan takaa.	206453	206498	lehtonen1910a	5	45
Halkaissut se oli säkin.	426127	426151	lehtonen1910a	3	24
Hän aikoi vetää häntä luokseen.	130809	130840	canth1886a	4	31
Hän aivan julmistui, saadakseen voiton.	233072	233111	lassila1910a	4	39
Hän aivan kuin jähmistyi.	52638	52663	pakkala1895a	3	25
Hän ajattelee pääskysenhattuja.	319659	319690	lehtonen1910a	2	31
Hän ajattelee, että linnaanhan tällaisesta joutuu.	507616	507666	lehtonen1910a	5	50
Hän ajattelee.	474472	474486	lehtonen1910a	1	14
Hän ajatteli raha-asioitaan.	185108	185136	canth1886a	2	28
Hän alkaa jo tulla.	570346	570365	lehtonen1910a	3	19
Hän alkoi taas jatkaa kuulustelua.	240318	240352	lassila1910a	4	34
Hän ärjyy.	504854	504864	lehtonen1910a	1	10
Hän avasi varovasti kouransa.	33066	33095	pakkala1895a	3	29
Hän ei kuin rehlehtieraamaan naapureilta viinaa.	751691	751739	lehtonen1910a	5	48
Hän ei laskenut sitä menemään enää.	123654	123689	pakkala1895a	5	35
Hän ei mene sisään koko iltana.	4330	4361	pakkala1895a	5	31
Hän ei oikein usko silmiään.	553266	553294	lehtonen1910a	4	28
Hän ei olisi tahtonut mennä edemmäksi.	113158	113196	pakkala1895a	5	38
Hän ei ollut uskonnollinen.	126330	126357	jarnefelt1916a	3	27
Hän ei osannut selittää.	23434	23458	jarnefelt1913a	3	24
Hän ei puhu juuri koskaan.	304660	304686	lehtonen1910a	4	26
Hän ei ruvennut yrittämäänkään.	50391	50422	jarnefelt1916a	3	31
Hän ei sitä voinut synniksi ymmärtää.	46260	46297	pakkala1895a	5	37
Hän ei suuttunut vähääkään.	113506	113533	jarnefelt1916a	3	27
Hän ei tiennyt enää mitään.	211769	211796	canth1886a	4	27
Hän ei todella niitä oikein kuulekaan.	361104	361142	lehtonen1910a	5	38
Hän ei uskaltanut katsoakaan sitä.	103087	103121	pakkala1895a	4	34
Hän ei uskonut semmoiseen.	16332	16358	jarnefelt1913a	3	26
Hän hakkasi kuin kaskea.	288890	288914	lassila1910a	3	24
Hän häpesi niin, että itki.	6902	6929	pakkala1895a	4	27
Hän harppailee kiireesti miesten aitan luokse.	104375	104421	lehtonen1910a	5	46
Hän hourailee.	115338	115352	jarnefelt1913a	1	14
Hän huokaisee pihalla.	685927	685949	lehtonen1910a	2	22
Hän huokaisee.	54065	54079	lehtonen1910a	1	14
Hän huudahti, että herroja tulee.	547003	547036	lehtonen1910a	4	33
Hän huusikin ihan uhkaavasti.	160836	160865	lassila1910a	3	29
Hän hymyilee vain.	564518	564536	lehtonen1910a	2	18
Hän hyppäsi siihen.	120684	120703	pakkala1895a	2	19
Hän hyssytteli ja koputti ruutua.	168073	168106	canth1886a	4	33
Hän ilahtui siitä ja ihastuksissaan äänsi.	121151	121193	pakkala1895a	5	42
Hän istuu niityllä leppien siimeksessä.	229080	229119	lehtonen1910a	4	39
Hän istuu siinä melkoisen kauan.	388720	388752	lehtonen1910a	4	32
Hän itki paljon katkerammin.	112979	113007	pakkala1895a	3	28
Hän jää varmuuden vuoksi hiukan loitommalle.	528027	528071	lehtonen1910a	5	44
Hän jatkoi työtään otsa hiessä.	270052	270083	lassila1910a	4	31
Hän jätti kätkyen ja juoksi nykäisemään.	32935	32975	canth1886a	5	40
Hän jätti Saaran vuorelle istumaan.	571374	571409	lehtonen1910a	4	35
Hän juoksee takaisin jyrkälle rinteelle.	383358	383398	lehtonen1910a	4	40
Hän juoksee.	262346	262358	lehtonen1910a	1	12
Hän juttelee yhtä ja toista.	696288	696316	lehtonen1910a	4	28
Hän juuttuu tähän rannalle, kunnes saa.	167582	167621	lehtonen1910a	5	39
Hän kääntyi kuuntelemaan toisten puhetta.	114100	114141	canth1886a	4	41
Hän kääntyy selin Maunoon.	484447	484473	lehtonen1910a	3	26
Hän kaatui kasvoilleen, ja kirosi hiljaa.	173155	173196	lehtonen1910a	5	41
Hän kait se oli.	24561	24577	canth1886a	3	16
Hän katoaa sisälle kodan ovesta.	81853	81885	lehtonen1910a	4	32
Hän katsahti nopeasti pukuansa.	58246	58277	lassila1910a	3	31
Hän katselee äitinsä hommia.	155495	155523	lehtonen1910a	3	28
Hän katselee hetken.	182118	182138	lehtonen1910a	2	20
Hän katselee hymyillen neitiin.	764368	764399	lehtonen1910a	3	31
Hän katselee maahan.	279880	279900	lehtonen1910a	2	20
Hän katselee Muttiseen niin palavasti.	556348	556386	lehtonen1910a	4	38
Hän katselee vilkkaasti taakseen.	234877	234910	lehtonen1910a	3	33
Hän katseli sitä mietteissään.	38668	38698	pakkala1895a	3	30
Hän katseli ympärilleen.	132622	132646	canth1886a	2	24
Hän katsoi ja näki Sarkkisen tädin.	125158	125193	pakkala1895a	5	35
Hän katsoi syrjään ja oli pahoillaan.	117283	117320	canth1886a	5	37
Hän katsoo säkkiin, ja alkaa ärjyä.	383180	383215	lehtonen1910a	5	35
Hän käypi joka päivä kotona.	116466	116494	pakkala1895a	4	28
Hän kerää sekä kypsiä että raakiloita.	316580	316618	lehtonen1910a	5	38
Hän kierteli ja kaarteli.	94309	94334	lassila1910a	3	25
Hän kiipeili niiden rintuuksia.	126059	126090	pakkala1895a	3	31
Hän kiukkuaa kahvia.	441372	441392	lehtonen1910a	2	20
Hän koettaa, koettaa.	119946	119967	lehtonen1910a	2	21
Hän koetti katsoa tuiskuiko siellä nyt.	126295	126334	pakkala1895a	5	39
Hän koetti rukoilla.	54962	54982	canth1886a	2	20
Hän kumartuu nyt niitä poimimaan.	316457	316490	lehtonen1910a	4	33
Hän kun ei ollut korjannut rakennuksiaan.	619770	619811	lehtonen1910a	5	41
Hän kun pitää sinusta niin paljon.	191252	191286	canth1886a	5	34
Hän kurkisti vyöliinan laidan alta.	34576	34611	pakkala1895a	4	35
Hän kuulee jotakin.	154451	154470	lehtonen1910a	2	19
Hän kuuntelee ja kuuntelee.	123479	123506	jarnefelt1913a	3	27
Hän kuunteli, sanoiko hänen suunsa mitään.	61361	61403	pakkala1895a	5	42
Hän kylpi aamupuolelle yötä.	289702	289730	lassila1910a	3	28
Hän kyselee, mitä tänne kuuluu, Putkinotkoon.	627052	627097	lehtonen1910a	5	45
Hän kysyi aina, tahtooko Nanna kuolla?	117374	117412	pakkala1895a	5	38
Hän kysyi, lukisiko hän isämeidän.	97207	97241	pakkala1895a	4	34
Hän kysyy, mitä Muttinen nauraa.	753496	753528	lehtonen1910a	4	32
Hän lähtee matkalle.	106463	106483	lehtonen1910a	2	20
Hän lähtee saunalle.	649922	649942	lehtonen1910a	2	20
Hän lähti puhuttelemaan poliisiherroja.	225174	225213	lassila1910a	3	39
Hän lönkyttää veräjälle.	383611	383635	lehtonen1910a	2	24
Hän matkii laivaa.	642769	642787	lehtonen1910a	2	18
Hän melkein itki.	21913	21930	pakkala1895a	2	17
Hän menee pihalle.	385108	385126	lehtonen1910a	2	18
Hän menee takaisin rotkoon.	383496	383523	lehtonen1910a	3	27
Hän menee tuvan taakse kalliolta katsomaan.	200629	200672	lehtonen1910a	5	43
Hän meni sisään.	4905	4921	pakkala1895a	2	16
Hän muistaa, miten Muttinen äsken kääntelehti.	667984	668030	lehtonen1910a	5	46
Hän muisti nyt aivan selvään.	41839	41868	pakkala1895a	4	29
Hän näkee Hurjan ja Ananiaksen.	523590	523621	lehtonen1910a	4	31
Hän näkee Muttisen käännähtelevän levottomasti penkillä.	665736	665792	lehtonen1910a	5	56
Hän näkee nuo terävät silmät.	274446	274475	lehtonen1910a	4	29
Hän näkee Topin käsissä tyhjän paperipussin.	572824	572868	lehtonen1910a	5	44
Hän näki puutarhassa paljon rouvia.	44223	44258	pakkala1895a	4	35
Hän nauraa melkein äänettömästi, silmät litteinä.	667849	667898	lehtonen1910a	5	49
Hän nauraa, tirskuu.	554215	554235	lehtonen1910a	2	20
Hän nautti joka sanastaan.	248207	248233	jarnefelt1916a	3	26
Hän nukkui hiljaa ja rauhallisesti.	235266	235301	canth1886a	4	35
Hän nukkuu kuin tukki.	19470	19492	lehtonen1910a	3	22
Hän nyökäyttelee päätänsä ja rypistelee kulmiaan.	763892	763941	lehtonen1910a	5	49
Hän odotti Vatasen tuloa.	221054	221079	lassila1910a	3	25
Hän oli aivan varma siitä.	51720	51746	pakkala1895a	4	26
Hän oli hauskasti punastunut.	253735	253764	jarnefelt1916a	3	29
Hän oli huomannut.	290997	291015	jarnefelt1916a	2	18
Hän oli kuin suutuksissaan äidille.	120967	121002	pakkala1895a	4	35
Hän oli lähtemäisillään.	157835	157859	canth1886a	2	24
Hän oli luvannut Nymarkille monta asiaa.	149595	149635	canth1886a	5	40
Hän oli pakahtua.	191139	191156	canth1886a	2	17
Hän oli paljosta hosumisesta lävitse uupunut.	242180	242225	canth1886a	5	45
Hän oli pudonnut poliisien syliin.	109638	109672	pakkala1895a	4	34
Hän oli todella kuin viritetty kello.	128950	128987	jarnefelt1916a	5	37
Hän oli vähän jo olevinaan.	111216	111243	pakkala1895a	4	27
Hän oli yöasussa, ja hätääntyneen näköinen.	235592	235635	canth1886a	5	43
Hän olisi hyvä heille kaikille.	115196	115227	pakkala1895a	4	31
Hän on herra, oikea.	438486	438506	lehtonen1910a	3	20
Hän on hetken taas vaiti.	147270	147295	lehtonen1910a	4	25
Hän on hetken vaiti.	457175	457195	lehtonen1910a	3	20
Hän on hirmuisen pikavihainen.	99729	99759	lehtonen1910a	3	30
Hän on jähmettynyt varmassa rauhassaan.	142487	142526	canth1886a	4	39
Hän on jo melkein täydellisesti tyyntynyt.	139637	139679	lehtonen1910a	5	42
Hän on kuohuksissaan.	281181	281202	lehtonen1910a	2	21
Hän on paremminkin iso kuin keskikokoinen.	294480	294522	lehtonen1910a	5	42
Hän on pelosta sekaannuksissaan.	499558	499590	lehtonen1910a	3	32
Hän on pudota välillä mutahautaan.	235706	235740	lehtonen1910a	4	34
Hän on punastunut, ja silmäkoloissa välkehtii.	158909	158955	lehtonen1910a	5	46
Hän on ruotsalainen.	216912	216932	jarnefelt1916a	2	20
Hän on sellainen unikeko iltasin.	100282	100315	jarnefelt1916a	4	33
Hän on taas hetken vaiti.	149058	149083	lehtonen1910a	4	25
Hän on taisteluun valmis vastustaja.	102305	102341	lehtonen1910a	4	36
Hän on tuokion vaiti.	713855	713876	lehtonen1910a	3	21
Hän on valkeassa tanssijaispuvussa.	147205	147240	jarnefelt1913a	3	35
Hän on vihainen.	104017	104033	lehtonen1910a	2	16
Hän on vihainen.	329876	329892	lehtonen1910a	2	16
Hän örisee.	104034	104045	lehtonen1910a	1	11
Hän päästi rämäkän huudon jo ajoissa.	69152	69189	pakkala1895a	5	37
Hän pelästyy ja suuttuukin.	261729	261756	lehtonen1910a	3	27
Hän pelkäsi, kun täti tuli.	109852	109879	pakkala1895a	4	27
Hän piirusteli minulle heidän suunnitelmiansa.	248234	248280	jarnefelt1916a	4	46
Hän poikkesi tieltä metsään.	94589	94617	pakkala1895a	3	28
Hän pöyristyi kokoon.	193687	193708	canth1886a	2	21
Hän puoleksi toivoi sitä, puoleksi pelkäsi.	132203	132246	canth1886a	5	43
Hän pureksii ja irvisteleekin.	440162	440192	lehtonen1910a	3	30
Hän pysähtyi portin pieleen kivijalkaa vasten.	113111	113157	pakkala1895a	5	46
Hän pysähtyi.	55590	55603	pakkala1895a	1	13
Hän pysähtyi.	21931	21944	canth1886a	1	13
Hän pyyhki huivinsa kulmalla kasvojaan.	27376	27415	canth1886a	4	39
Hän raapaisee reittään.	146886	146909	lehtonen1910a	2	23
Hän riemastui, posket karahtivat kuumiksi.	30478	30520	pakkala1895a	4	42
Hän rohkaisi luontonsa ja lähti.	276033	276065	lassila1910a	4	32
Hän rohkaisi mieltään ja meni sisään.	22164	22201	canth1886a	5	37
Hän rykäsi varakkaan isäntämiehen tavalla.	212122	212164	lassila1910a	4	42
Hän sai piiskat.	73712	73728	pakkala1895a	2	16
Hän säksättää.	102342	102356	lehtonen1910a	1	14
Hän sanoo naivansa Sanelman.	795982	796010	lehtonen1910a	3	28
Hän sattuu katsahtamaan epäillen Sanelmaan.	227025	227068	lehtonen1910a	4	43
Hän se lyö häkälöylyn.	699096	699118	lehtonen1910a	3	22
Hän seisoi aivan toimettomana.	734177	734207	lehtonen1910a	3	30
Hän seisoi mietteissään vehnäpeltoon päin kääntyneenä.	288310	288364	jarnefelt1916a	5	54
Hän seisoo nyt pitkävartinen atrain kädessä.	690130	690174	lehtonen1910a	5	44
Hän seurasi poikien pallonlyöntiä.	75762	75796	pakkala1895a	3	34
Hän siirtyi syrjään, tieltä pois.	17983	18016	canth1886a	4	33
Hän sivuutti vanhimmatkin toverinsa.	16383	16419	jarnefelt1913a	3	36
Hän suuttui.	79456	79468	lehtonen1910a	1	12
Hän syöksyi ulos ja purskahti itkemään.	4289	4328	pakkala1895a	5	39
Hän tahtoisi tietää, mitä he tekevät.	609208	609245	lehtonen1910a	5	37
Hän tahtoo ilmoittaa Maunolle suostumuksensa.	526507	526552	lehtonen1910a	4	45
Hän taisi olla silloinkin juovuksissa.	10199	10237	jarnefelt1913a	4	38
Hän tarkastaa Muttista.	548039	548062	lehtonen1910a	2	23
Hän tempaisee hametta.	386381	386403	lehtonen1910a	2	22
Hän tiesi sen olevan hänelle tarkotetun.	199312	199352	lassila1910a	5	40
Hän tirkistelee iloisin silmin.	665918	665949	lehtonen1910a	3	31
Hän törähyttää putkeensa.	210301	210326	lehtonen1910a	2	25
Hän tulee kaiketi heti paikalla.	106341	106373	jarnefelt1913a	4	32
Hän tulee marjametsästä.	313353	313377	lehtonen1910a	2	24
Hän tulee takaisin kotiin.	139540	139566	lehtonen1910a	3	26
Hän tuli levottomaksi.	17843	17865	pakkala1895a	2	22
Hän tunnustaa äidille kaikki.	34966	34995	pakkala1895a	3	29
Hän tunsi huonoksi itsensä Susannan rinnalla.	38106	38151	pakkala1895a	5	45
Hän tunsi kuin vihaa äitiäkin kohtaan.	74586	74624	pakkala1895a	5	38
Hän tunsi olevansa leski.	194932	194957	lassila1910a	3	25
Hän tuntee ne.	330068	330082	lehtonen1910a	2	14
Hän tuntee nyt päässeensä alkuun.	636358	636391	lehtonen1910a	4	33
Hän tuntui niin vieraalta, niin ventovieraalta.	193586	193633	canth1886a	5	47
Hän turvautui kiitollisena Nymarkiin.	165758	165795	canth1886a	3	37
Hän tuudittaa.	521618	521632	lehtonen1910a	1	14
Hän työntää sen koppaa myöten suuhunsa.	382574	382613	lehtonen1910a	5	39
Hän tyyntyi vasta pitkän ajan kuluttua.	115899	115938	pakkala1895a	5	39
Hän ummisti silmänsä.	126633	126654	pakkala1895a	2	21
Hän unohti jo kahvinkin ja leppyi.	99031	99065	lassila1910a	5	34
Hän vahti oveen tuijottaen.	31454	31481	pakkala1895a	3	27
Hän vain myhähtää sieraimiinsa.	142595	142626	lehtonen1910a	3	31
Hän valitsee melkeinpä huonoimman veneen.	286731	286772	lehtonen1910a	4	41
Hän valmiina odotti äidin viimeistä käskyä.	62158	62201	pakkala1895a	5	43
Hän vapisee.	80688	80700	lehtonen1910a	1	12
Hän vastasi jonkun sanan, miten sattui.	218569	218608	canth1886a	5	39
Hän vastasi pyytäneensä eväitä rekeen.	251685	251723	jarnefelt1916a	4	38
Hän vetää kalan toisensa jälkeen.	626798	626831	lehtonen1910a	4	33
Hän vetää yhä kovemmin.	180231	180254	lehtonen1910a	3	23
Hän vetäytyi takaisin oven luokse.	272018	272052	lehtonen1910a	4	34
Hän vihastui koko mokomalle miehelle.	255176	255213	lassila1910a	4	37
Hän vihelsi ja kutsui Hurjaa.	510325	510354	lehtonen1910a	4	29
Hän vilkaisee kotaan, jossa hämärtyy.	671574	671611	lehtonen1910a	4	37
Hän vilkaisee vielä ympärilleen.	274356	274388	lehtonen1910a	3	32
Hän vilkasi vain vähän syrjäsilmällä sivuilleen.	59437	59485	pakkala1895a	5	48
Hän viskasi vyöliinan silmiltään.	35153	35186	pakkala1895a	3	33
Hän yskii ja laskeutuu ihan maanrajaan.	657350	657389	lehtonen1910a	5	39
Hänellä ei ollut sylkeäkään suussa.	97073	97108	pakkala1895a	4	35
Hänellä oli äidille joululahja.	298	329	pakkala1895a	3	31
Hänellä oli niin ikävä.	107906	107929	pakkala1895a	3	23
Hänellä oli ollut ikävä Aappoa.	111352	111383	pakkala1895a	4	31
Hänellä oli silloin rahaa.	97436	97462	lehtonen1910a	3	26
Hänellä oli toivoa taaskin.	195568	195595	canth1886a	3	27
Hänellä oli väliin hyvin hauska.	116809	116841	pakkala1895a	4	32
Hänellä on nyt muuta ajattelemista.	96225	96260	lehtonen1910a	4	35
Hänellä on punainen pusero.	131677	131704	lehtonen1910a	3	27
Hänellä ylimalkaan ei ollut mitään aikeita.	105447	105490	jarnefelt1916a	5	43
Hänelle oli muuan kamari.	107236	107261	pakkala1895a	3	25
Hänelle pitää maksaa.	597187	597208	lehtonen1910a	2	21
Hänelle se annettiin.	81002	81023	canth1886a	2	21
Hänelle, Juutakselle, se varmaan irvisteli.	360826	360869	lehtonen1910a	4	43
Häneltä oli ihan itku tulossa.	77540	77570	pakkala1895a	4	30
Hänen entinen ankaruutensa tuntui julmuudelta.	61828	61874	pakkala1895a	4	46
Hänen kasvonsa olivat kauttaaltaan yksiväriset, tummanpunaiset.	36031	36094	jarnefelt1916a	5	63
Hänen katseensa on pysähtynyt yhteen paikkaan.	288725	288771	jarnefelt1916a	5	46
Hänen kulkiessaan läänissä.	407796	407823	lehtonen1910a	2	27
Hänen kyntensä ovat veressä ja madoissa.	626832	626872	lehtonen1910a	5	40
Hänen mieltään karvasteli.	129783	129809	canth1886a	2	26
Hänen olisi puhuttava tipoistaan.	274412	274445	lehtonen1910a	3	33
Hänen rintansa kohoilee.	724974	724998	lehtonen1910a	2	24
Hänen ruskeat silmänsä välkähtävät.	120672	120707	lehtonen1910a	3	35
Hänen tähtensä minun täytyy elää.	152896	152929	jarnefelt1913a	4	33
Hänen tekisi mielensä riipaista kätkyt.	386145	386184	lehtonen1910a	4	39
Hänen tekisi mieli kysyä, että missä.	259810	259847	lehtonen1910a	5	37
Hänen tukkaansa on nykäisty.	124541	124569	lehtonen1910a	3	28
Hänestä oli niin äärettömän hauska.	128576	128611	pakkala1895a	4	35
Hankin Aina Kustavan pakinoilleni.	493374	493408	lehtonen1910a	3	34
Hänkin oli tullut uimaan.	91566	91591	jarnefelt1916a	3	25
Hanna ja Lyyli olivat hyvin toimessa.	20390	20427	pakkala1895a	5	37
Hannalle ja Lyylille käärittiin huivit hatuiksi.	25853	25901	pakkala1895a	5	48
Hänpä ei oikein usko niitä.	140682	140709	lehtonen1910a	4	27
Häntä alkaa pistellä tuollainen pöyhkeily.	144088	144130	lehtonen1910a	4	42
Häntä täytyy vaan osata lukea.	141203	141233	canth1886a	4	30
Harjani liehuu ja sierameni tulta syöksevät.	129095	129139	jarnefelt1913a	5	44
Harjulan pihaan vihdoin päästiin.	87261	87294	canth1886a	3	33
Harmaa rouva ei ottanut tätä kuullakseen.	11798	11839	jarnefelt1913a	5	41
Harmaa.	212062	212069	lehtonen1910a	0	7
Harmenee tuo hänen tukkansakin.	649730	649761	lehtonen1910a	3	31
Harmillista on ruveta töihin näin pyhävaatteissa.	156609	156658	lehtonen1910a	5	49
Harvoin senmoinen kettu antaa itsensä ammuttavaksi.	222160	222211	lehtonen1910a	5	51
Harvoja huonekaluja seinäin vierustoilla.	136776	136817	jarnefelt1913a	3	41
Hätä tuli Jussin puolesta.	224604	224630	lassila1910a	3	26
Hautajaishommat olivat menneet ihan myttyyn.	69304	69348	pakkala1895a	4	44
Hautaristiä oli tiheässä yltympäri.	237595	237630	canth1886a	3	35
Hautuumaan ohi päästyä poikkesin pappilan tielle.	79704	79753	jarnefelt1913a	5	49
He ajaa köröttivät eteenpäin.	103040	103069	lassila1910a	3	29
He alkoivat tupakoida.	228309	228331	lassila1910a	2	22
He alkoivat tyyntyä.	228011	228031	lassila1910a	2	20
He huusivat erään laivan nimeä.	40575	40606	pakkala1895a	4	31
He ihastuksella ihmettelivät Olgaa.	20833	20868	pakkala1895a	3	35
He juoksivat keskikatua rinnatusten.	155405	155441	lassila1910a	3	36
He kävivät edellä.	86405	86423	canth1886a	2	18
He kiersivät toista katua vastaan.	23484	23518	pakkala1895a	4	34
He kiipesivät kaikki kalliot.	86384	86413	jarnefelt1916a	3	29
He kuuntelevat Malakiaksen juttua.	676470	676504	lehtonen1910a	3	34
He laskeutuvat vuorelta.	612164	612188	lehtonen1910a	2	24
He luistelivat käsi kädessä mitään virkkamatta.	204195	204242	canth1886a	5	47
He menevät nyt heinäpellon poikki.	372107	372141	lehtonen1910a	4	34
He menevät soutelemaan.	239233	239256	jarnefelt1916a	2	23
He menivät sisään.	208246	208264	lassila1910a	2	18
He neuvottelivat keskenään.	62941	62968	jarnefelt1913a	2	27
He nostavat jauhot veräjästä pihan puolelle.	443909	443953	lehtonen1910a	5	44
He nousivat pöydästä.	147132	147153	canth1886a	2	21
He olivat kuin kaksosveljet.	101276	101304	lassila1910a	3	28
He olivat lähdössä.	60568	60587	jarnefelt1913a	2	19
He olivat nyt kauvan vaiti.	22054	22081	lassila1910a	4	27
He ovat alkaneet minua suorastaan vihata.	776207	776248	lehtonen1910a	5	41
He ovat.	6574	6582	jarnefelt1913a	1	8
He palaavat kävelyltä.	113472	113494	jarnefelt1913a	2	22
He panevat moottorin lukkoon.	607306	607335	lehtonen1910a	3	29
He pyysivät ja rukoilivat.	2530	2556	pakkala1895a	3	26
He samoilivat kaikki tiet ja polut.	86414	86449	jarnefelt1916a	5	35
He seisahtuvat veräjällä.	443712	443737	lehtonen1910a	2	25
He tietävät toista.	134015	134034	jarnefelt1913a	2	19
Heidän perästään lähtee Saara, kantaen maitokannua.	573214	573265	lehtonen1910a	5	51
Heidän välillään syntyy taistelu.	101574	101607	jarnefelt1913a	3	33
Heikura vetäisi muutamia savuja.	14392	14424	canth1886a	3	32
Heillä on eväätkin.	57248	57267	pakkala1895a	2	19
Heillä on iso kivi alasimena.	696810	696839	lehtonen1910a	4	29
Heiluttaa sitä pari kertaa.	15936	15963	lehtonen1910a	3	27
Heinämiehet alkavat lähteä rannalta.	632907	632943	lehtonen1910a	3	36
Heinämiehet niittävät ja haravoivat.	615350	615386	lehtonen1910a	3	36
Heinäntekoakin olisi.	306164	306185	lehtonen1910a	1	21
Heinäpouta.	319121	319132	lehtonen1910a	0	11
Heinäsirkat sirittävät helteisellä rinteellä.	582811	582856	lehtonen1910a	3	45
Heinässäkö?	420697	420708	lehtonen1910a	0	11
Heistä molemmista oli hauska, varsinkin Lyylistä.	22474	22523	pakkala1895a	5	49
Heitä armaitani, lapsiani varten.	42292	42325	jarnefelt1913a	3	33
Heittäytyy ojennetuin käsin kuoleman syliin.	154605	154649	jarnefelt1913a	4	44
Hekin saivat hurjastella kerran.	70285	70317	pakkala1895a	3	32
Hektorko?	96050	96059	jarnefelt1913a	0	9
Helle on, herttainen, kesä kultainen.	319055	319092	lehtonen1910a	4	37
Hellu korjasi tilat ja lakaisi lattian.	67934	67973	canth1886a	5	39
Hellu syrjästä kurotti lusikkaansa.	48220	48255	canth1886a	3	35
Hellun täytyi lähteä ulos pussineen.	37499	37535	canth1886a	4	36
Hellunkin alkoi kyynelet tippua pitkin poskia.	34085	34131	canth1886a	5	46
Helpostihan hän pääsikin.	76114	76139	pakkala1895a	2	25
Helppo ansio hyvä varsinkin köyhistä, avuttomista.	663017	663067	lehtonen1910a	5	50
Helppo sanoa.	46363	46376	jarnefelt1913a	1	13
Heluna ei ole millänsäkään.	400526	400553	lehtonen1910a	3	27
Heluna ei tottele.	401263	401281	lehtonen1910a	2	18
Hen puhhu vehe soome.	94841	94862	jarnefelt1913a	3	21
Hengenvaarassa he olivat olleet.	84529	84561	jarnefelt1916a	3	32
Hengitys oli epätasainen ja läähättävä.	60836	60875	canth1886a	4	39
Henki korisi kurkussa, ruumis nytkähteli.	216957	216998	canth1886a	4	41
Herättyäni koetin ensin nauraa.	68208	68239	jarnefelt1913a	3	31
Hermot repivät aikuisiltakin.	688132	688161	lehtonen1910a	2	29
Herra koettelee.	115433	115449	jarnefelt1913a	1	16
Herra on jo kotona.	93223	93242	jarnefelt1913a	3	19
Herra pilkistää oven raosta hiljaa ulos.	663634	663674	lehtonen1910a	5	40
Herrat ovat liitossa, ja Pönkönen.	299689	299723	lehtonen1910a	4	34
Hetken aikaa oli Johnkin nyt ääneti.	181374	181410	canth1886a	5	36
Hetken hän siellä viipyy.	81886	81911	lehtonen1910a	3	25
Hetken kuluttua avautuu tuvan ovi hiljaa.	130162	130203	jarnefelt1913a	5	41
Hetken on hiljaista.	677042	677062	lehtonen1910a	2	20
Hetkessä ne tottuvat.	370964	370985	lehtonen1910a	2	21
Hetki oli kulunut.	205532	205550	canth1886a	2	18
Hevonen koluuttelee rekeään ladon luona.	632646	632686	lehtonen1910a	4	40
Hevoselle?	279681	279691	lehtonen1910a	0	10
Hevosemme kahlaa päärakennuksen portaan eteen.	214394	214440	jarnefelt1916a	4	46
Hevosen leikkiä se sellainen on.	494022	494054	lehtonen1910a	4	32
Hevosta odotellessa hän itse söi.	50889	50922	lehtonen1910a	4	33
Hidas luonteeltaan.	47252	47271	lehtonen1910a	1	19
Hierontaa.	6036	6046	jarnefelt1913a	0	10
Hihii, hakkaamaan niitä vastoja tuohon selkään.	693531	693578	lehtonen1910a	5	47
Hihuu.	539987	539993	lehtonen1910a	0	6
Hihuu.	642280	642286	lehtonen1910a	0	6
Hiiden kattilaanko se toinen kiulu sitten?	86963	87005	lehtonen1910a	5	42
Hiiden tuuttiinko se?	155353	155374	lehtonen1910a	2	21
Hiisi kaikkiakin, oikein pistää vihaksi.	99180	99220	canth1886a	4	40
Hikipisarat nousivat otsalleni.	84794	84825	jarnefelt1913a	2	31
Hiljaa hän tulee.	608991	609008	lehtonen1910a	2	17
Hiljaa suhahtelevat viikatteet ja haravat niityllä.	632594	632645	lehtonen1910a	5	51
Hiljaa.	373252	373259	lehtonen1910a	0	7
Hiljaista.	70112	70122	kilpi1903a	0	10
Hiljaisuus vallitsee.	440928	440949	lehtonen1910a	1	21
Hiljaisuus vallitsee.	137422	137443	jarnefelt1913a	1	21
Hinaaja kuljettaa siellä halkolotjia tai tukkilauttaa.	762746	762800	lehtonen1910a	5	54
Hiottamalla vaaralliset taudin itiöt lauteiden alle.	661066	661118	lehtonen1910a	5	52
Hirtän.	386756	386763	lehtonen1910a	0	7
Hitaasti alkaa hän tulla lähemmäksi.	535642	535678	lehtonen1910a	4	36
Hiukan hämillään painoi hän nenäliinaa kasvoilleen.	160801	160852	canth1886a	5	51
Hiukset olivat kiharassa vielä eiliseltä.	169593	169634	canth1886a	4	41
Hm, nyt minä olen nyreä.	763797	763821	lehtonen1910a	4	24
Hoitaja avasi kopin oven.	89044	89069	canth1886a	3	25
Hoitaja kynsäisi korvallistaan.	87343	87374	canth1886a	2	31
Hoiti lapsia ja ompeli.	126713	126736	canth1886a	3	23
Hojotat kuin komersootti.	678560	678585	lehtonen1910a	2	25
Holauta.	312017	312025	lehtonen1910a	0	8
Holpainen ei välittänyt vastata.	97304	97336	canth1886a	3	32
Holpainen nosti lamppua, katsoakseen häntä tarkemmin.	55892	55945	canth1886a	5	53
Holpainen piteli häntä kiinni molemmin käsin.	78678	78723	canth1886a	5	45
Holpainen valvoi, hengityksestä hän sen kuuli.	62760	62806	canth1886a	5	46
Holpainen yhä katsoi häneen.	59601	59629	canth1886a	3	28
Holpaisen sydäntä ne viileksivät kuin veitsellä.	72182	72230	canth1886a	5	48
Hongikon rinne tuolla lämpenee.	112734	112765	lehtonen1910a	3	31
Honottaa tuo Malakiaskin.	425151	425176	lehtonen1910a	2	25
Horteessaan on hän kuullut puhuttavan haisemisestakin.	455088	455142	lehtonen1910a	5	54
Houkutellut lupauksilla.	779173	779197	lehtonen1910a	1	24
Houkuttelipa hän yhtä luokseenkin, säälien sitä.	337533	337581	lehtonen1910a	5	48
Housut eivät oleet kuin polviin asti.	110231	110268	pakkala1895a	5	37
Huhut joutuivat vanhempien korviin.	89262	89297	jarnefelt1916a	3	35
Hukka rupeaa ja laulaa suunsa puhtaaksi.	502363	502403	lehtonen1910a	5	40
Hullua oli semmoista pelätä.	224381	224409	canth1886a	3	28
Hulluhan se sellainen mies.	475298	475325	lehtonen1910a	3	27
Humaliston vieressä rantaveräjällä katselee hän lahdelle.	649943	650000	lehtonen1910a	5	57
Huomasi vasta puistoon tullessaan.	58588	58622	pakkala1895a	3	34
Huomauttaa vain elämään siivolla.	290815	290848	lehtonen1910a	3	33
Huomenaamulla on kuoppa tyhjä.	86201	86231	pakkala1895a	3	30
Huomenna vien tämän paperin Käkriäiselle.	787723	787764	lehtonen1910a	4	41
Huone oli suuri ja kolkko.	52617	52643	jarnefelt1913a	4	26
Huone vilisi Vapun silmissä.	54273	54301	pakkala1895a	3	28
Huoneessa ei hänen näkyvissään ollut ketään.	125824	125868	pakkala1895a	5	44
Hurja häärii Ananiaksen kintereillä aittojen luona.	573399	573450	lehtonen1910a	5	51
Hurja haukkuu siellä lammen toisella puolella.	234912	234958	lehtonen1910a	5	46
Hurja haukkuu.	641193	641207	lehtonen1910a	1	14
Hurja heittäytyy selälleen ja kieputtelee häntäänsä.	541955	542007	lehtonen1910a	5	52
Hurja juoksee Ananiaksen ja hevosen edeltä.	634969	635012	lehtonen1910a	5	43
Hurja juoksee veneessä.	189183	189206	lehtonen1910a	2	23
Hurja on leikkisällä tuulella, illan viileässä.	639850	639897	lehtonen1910a	5	47
Hurja rähisee jälleen vihaisesti.	406340	406373	lehtonen1910a	3	33
Hurja se räyskyttää kaiket syysyöt.	761857	761892	lehtonen1910a	4	35
Hurjan rähinä kajahtelee kovempana.	407059	407094	lehtonen1910a	3	35
Huudahtaa, ettei siellä enää häkää tunnukaan.	698834	698879	lehtonen1910a	5	45
Huusi niin, että siihen heräsi.	230456	230487	canth1886a	4	31
Huutaa korvan juuressa.	82413	82436	lehtonen1910a	2	23
Hyh, mitähän noillakin virkaa, noilla kaaleilla.	207148	207196	lehtonen1910a	5	48
Hyräilee ensin tuskin kuuluvasti.	175803	175836	lehtonen1910a	3	33
Hyttyset tanssivat auringon punertavassa hohteessa.	608791	608842	lehtonen1910a	4	51
Hyttysiä hyrrää kuin aina paremmin illalla.	510971	511014	lehtonen1910a	5	43
Hyvä ihme tokkii.	200926	200943	canth1886a	2	17
Hyvä on.	701877	701885	lehtonen1910a	1	8
Hyvä onkin nyt vilja kallionkolossa.	60198	60234	lehtonen1910a	4	36
Hyvä vaivaisille jäsenille.	319093	319120	lehtonen1910a	2	27
Hyvää yötä, Paavali.	141469	141489	jarnefelt1913a	2	20
Hyve iltta, hyve iltta, rakas pikku.	93920	93956	jarnefelt1913a	5	36
Hyvin ennätetään.	557315	557332	lehtonen1910a	1	17
Hyvin tehty se on.	201990	202008	lehtonen1910a	3	18
Ihalainen puhalteli vihaa.	284149	284175	lassila1910a	2	26
Ihalainenko se on ja Vatanen?	53864	53893	lassila1910a	4	29
Ihan heidän läheltään kuului nyt puhetta.	100856	100897	pakkala1895a	5	41
Ihan itkeskeli, kotia kaipasi.	520533	520563	lehtonen1910a	3	30
Ihan kuin kusiaispesässä.	311560	311585	lehtonen1910a	2	25
Ihan kylmästihän minä häntä katselen.	93110	93147	jarnefelt1916a	4	37
Ihan Putkinotkon mökin lahdelta.	527337	527369	lehtonen1910a	3	32
Ihan suott'aikoja ilveilette.	150265	150294	jarnefelt1913a	2	29
Ihaninta on rauhana levätä.	75659	75686	kilpi1903a	3	27
Ihme, että sen haukkakin säästi.	41778	41810	lehtonen1910a	4	32
Ihme, ettei se tuli tartu mummoonkin.	122853	122890	lehtonen1910a	5	37
Ihmeen nopeasti kapuaa Käkriäinen mäkeä.	523549	523589	lehtonen1910a	4	40
Ihminen on kaunis?	39330	39348	kilpi1903a	2	18
Ihminenkö tasainen ja tyyneeksi asettunut?	38693	38735	kilpi1903a	4	42
Ihmiselämä kuitenkin, kaikkea muuta kalliimpi.	782731	782777	lehtonen1910a	4	46
Ihmiset kokoontuivat reunalle sitä katsomaan.	219734	219779	canth1886a	4	45
Ihmiset suhisevat Mauno-enon varastaneen lampaitakin.	472900	472953	lehtonen1910a	4	53
Ihmisiä kulki kadulla ristiin rastiin.	236931	236969	canth1886a	4	38
Ikkunalaudoilla veripisarankukkia.	137232	137266	jarnefelt1913a	1	34
Ilkeä oli tämäkin neiti viime kesänä.	736974	737011	lehtonen1910a	5	37
Ilkeäksi se on tullut.	622479	622501	lehtonen1910a	3	22
Illalla tuli Alma sinne käsitöineen.	179000	179036	canth1886a	4	36
Illan ilma himmenee.	664034	664054	lehtonen1910a	2	20
Illan taivas paistoi keltaisena.	741509	741541	lehtonen1910a	3	32
Ilma nasahtaa.	789640	789654	lehtonen1910a	1	14
Ilma pysyi yhä suojaisena.	56646	56672	jarnefelt1916a	3	26
Ilman säkkiä.	384112	384125	lehtonen1910a	1	13
Ilmanranta punertaa.	58623	58643	lehtonen1910a	1	20
Ilmassa oli ukkosta, oikeata Liperin ukkosta.	280771	280816	lassila1910a	5	45
Ilmassa oli ukkosta.	95081	95101	lassila1910a	2	20
Ilmeinen tuli.	504477	504491	lehtonen1910a	1	14
Iloa oli ympärillä.	189160	189179	canth1886a	2	19
Iloisesti huudahtaa silloin Rosina.	648825	648860	lehtonen1910a	3	35
Iloisuus tarttuu toisiin.	106731	106756	jarnefelt1913a	2	25
Iloiten ja laulellen palasi joukko kotia.	104899	104940	pakkala1895a	5	41
Ilta olikin jo kovin pimennyt.	177049	177079	jarnefelt1916a	4	30
Ilta on viilentynyt, mutta vielä lämmin.	760455	760495	lehtonen1910a	5	40
Ilta tuli, mutta Ihalaista ei näkynyt.	39584	39622	lassila1910a	5	38
Ilta tuntuu syksyiseltä.	758115	758139	lehtonen1910a	2	24
Imelä haju, sellainen että kaivaa sydänalaa.	583339	583383	lehtonen1910a	5	44
Isä ja äiti nauroivat.	82124	82146	pakkala1895a	3	22
Isä käännähti silloin ja örähti jotain.	75765	75804	lehtonen1910a	5	39
Isä on pieksäessään isä.	165824	165848	lehtonen1910a	3	24
Isäkin lähti töistä.	236286	236306	lehtonen1910a	2	20
Isällä oli suuri musta parta.	42680	42709	pakkala1895a	4	29
Isäntä antaa heidän asua niinkuin entistenkin.	290227	290273	lehtonen1910a	5	46
Isäntäni kädet vapisevat yhä tuntuvammin.	130282	130323	jarnefelt1913a	4	41
Isäntäni kädet vapisevat.	130482	130507	jarnefelt1913a	2	25
Isäsi, kuten tiedät, jakoi omaisuutensa köyhille.	144792	144841	jarnefelt1913a	5	49
Iso kotapata, se, jonka Mauno tietää.	309962	309999	lehtonen1910a	5	37
Iso Sanelma riisuutuu nopeasti.	724462	724493	lehtonen1910a	3	31
Iso Sanelma vastaa hänelle saunan ovelta.	570151	570192	lehtonen1910a	5	41
Isompia ja pienempiä sikin sokin.	21274	21307	lehtonen1910a	4	33
Isot siat niistä olivat kuin lankunkappaleita.	336248	336294	lehtonen1910a	5	46
Isot varpaat rupesivat painimaan.	124941	124974	pakkala1895a	3	33
Istahti kynnykselle, ja alkoi haukotella.	570737	570778	lehtonen1910a	4	41
Istui siinä monta viikkoa.	627234	627260	lehtonen1910a	3	26
Istui tarinoimassa.	52059	52078	lehtonen1910a	1	19
Istuiksen kivelle.	502011	502029	lehtonen1910a	1	18
Istuu aidan juuressa.	381475	381496	lehtonen1910a	2	21
Istuu siellä kuin ryökkinä sohvalla, kekottaa.	629324	629370	lehtonen1910a	5	46
Itikat eivät antaneet heille rauhaa.	148962	148998	canth1886a	4	36
Itikatkin pistelevät siellä niinkuin menneenä kesänä.	608450	608503	lehtonen1910a	5	53
Itkeä nyhertäen lähti Mikko kävelemään.	67456	67495	pakkala1895a	4	39
Itkin kohtaloani, luulin kuolevani.	41660	41695	jarnefelt1913a	3	35
Itkua ja valitusta kuului tyttöjoukossa.	67958	67998	pakkala1895a	4	40
Itkumielin katseli hän kämmenelleen.	33306	33342	pakkala1895a	3	36
Itse hän on mennyt niin lähelle.	274222	274254	lehtonen1910a	5	32
Itse keittopaikka on tämän onkalon takana.	799232	799274	lehtonen1910a	5	42
Itse tahdon vankeutta, lepoa, unta tahdon.	110482	110524	jarnefelt1913a	5	42
Itsekseen: Tshort jih paimjot.	105916	105946	jarnefelt1913a	3	30
Itsensä sietäisi Topin saada selkäsauna.	123544	123584	lehtonen1910a	4	40
Itsensä täytyy Muttisen solmia se siihen.	600532	600573	lehtonen1910a	5	41
Itsepä sen kerroit.	491913	491932	lehtonen1910a	2	19
Ja Aapelihan tahtoisi köllötellä niin mukavasti.	649445	649493	lehtonen1910a	5	48
Ja Aappo tiesi olevansa helisemässä.	69115	69151	pakkala1895a	4	36
Ja aidanseipään rusahdus.	76464	76489	lehtonen1910a	2	25
Ja aikoo antaa niitä muillekin pennuille.	130572	130613	lehtonen1910a	5	41
Ja akkansa.	503970	503981	lehtonen1910a	1	11
Ja akoilla.	380542	380553	lehtonen1910a	1	11
Ja alakerrassa pylväskuisti.	10489	10517	lehtonen1910a	2	28
Ja alkavat ne jo pilkata Juutastakin.	65367	65404	lehtonen1910a	5	37
Ja alkoivat lähteä saunalle.	706753	706781	lehtonen1910a	3	28
Ja Ananiaskin uskoo vähän.	221928	221954	lehtonen1910a	3	26
Ja antaa tällaisen tilan olla isännättä.	336688	336728	lehtonen1910a	5	40
Ja antaako tämä Aapeli?	783902	783925	lehtonen1910a	3	23
Ja edessä puna- ja siniruudullinen esiliina.	155573	155617	lehtonen1910a	5	44
Ja eihän se Juutas tosissaan.	599475	599504	lehtonen1910a	4	29
Ja eihän sika heinillä elä.	337442	337469	lehtonen1910a	4	27
Ja eikös Ester saanutkaan mitään?	435643	435676	lehtonen1910a	4	33
Ja eipä tuo näyttänyt paljoa muuttuneen.	118201	118241	lassila1910a	5	40
Ja entäs lehmät?	57993	58009	lassila1910a	2	16
Ja entinen loppui.	603361	603379	lehtonen1910a	2	18
Ja ero siitä tuli.	249311	249329	lehtonen1910a	3	18
Ja että laiva huutaa.	155190	155211	lehtonen1910a	3	21
Ja että siellä on Muttinen.	535534	535561	lehtonen1910a	4	27
Ja ettekö te kuule?	645344	645363	lehtonen1910a	3	19
Ja eukon sukulaiset.	778534	778554	lehtonen1910a	2	20
Ja haiset aina.	453896	453911	lehtonen1910a	2	15
Ja hän heitti moittivan katseen Johniin.	121038	121078	canth1886a	5	40
Ja hän kantaa tosiaan.	381275	381297	lehtonen1910a	3	22
Ja hän laskee työaseen kädestään.	780966	780999	lehtonen1910a	4	33
Ja hän lauloi ja tanssi.	70508	70532	lehtonen1910a	4	24
Ja hän miettii asiaa.	719115	719136	lehtonen1910a	3	21
Ja hän otti.	95127	95139	lehtonen1910a	2	12
Ja hän punoittaa muustakin kuin helteestä.	397774	397816	lehtonen1910a	5	42
Ja hän saakin.	219820	219834	lehtonen1910a	2	14
Ja hän tulee kodan penkille levähtämään.	721006	721046	lehtonen1910a	5	40
Ja hän tulistuu vastarintaan.	478108	478137	lehtonen1910a	3	29
Ja hän voi joutua vieläkin pitemmälle.	28356	28394	jarnefelt1916a	5	38
Ja hänen akalleen, naarastiikerinä karjuvalle.	768823	768869	lehtonen1910a	4	46
Ja hänen akkansa.	493281	493298	lehtonen1910a	2	17
Ja hänen ruokahalunsa on kasvanut.	532532	532566	lehtonen1910a	4	34
Ja hänestä ne olivatkin aivan oikeat.	22619	22656	pakkala1895a	5	37
Ja häntä aivan kuin halutti tuohon.	120316	120351	pakkala1895a	5	35
Ja hätäkös on hänellä.	291232	291254	lehtonen1910a	3	22
Ja hävytön pitää ollakin.	281704	281729	lehtonen1910a	3	25
Ja he erotettiin koulusta.	63131	63157	jarnefelt1913a	3	26
Ja he juttelevat.	475744	475761	lehtonen1910a	2	17
Ja he lähtivät kaupungille kävelemään.	22991	23029	pakkala1895a	4	38
Ja he menevät.	614277	614291	lehtonen1910a	2	14
Ja helpommalla riuhtaisisi.	184948	184975	lehtonen1910a	2	27
Ja hevosen kaviot kolisevat aisoihin.	521732	521769	lehtonen1910a	4	37
Ja hevosia, ja sikojakin.	506863	506888	lehtonen1910a	3	25
Ja hiivaa.	310232	310242	lehtonen1910a	1	10
Ja hiottaa niin.	390380	390396	lehtonen1910a	2	16
Ja hyppi ilosta vielä aivan tyttömäisesti.	55489	55531	jarnefelt1916a	5	42
Ja hyvä on toukoviljakin.	476221	476246	lehtonen1910a	3	25
Ja hyväthän täällä Putkinotkossa ovat maat.	476429	476472	lehtonen1910a	5	43
Ja ilmaisia renkejä, ne pojat.	94269	94299	lehtonen1910a	4	30
Ja ilomme olisi taaskin yhteinen.	208216	208249	jarnefelt1916a	4	33
Ja iltasilla niitä entisiä.	220987	221014	canth1886a	3	27
Ja inttää jälleen tulevansa.	257359	257387	lehtonen1910a	3	28
Ja isä istuikin jo syömässä.	78578	78606	pakkala1895a	4	28
Ja isä myy viinaa.	236308	236326	lehtonen1910a	3	18
Ja itseään ylisti.	8990	9008	pakkala1895a	2	18
Ja itsekin keksinyt uusia.	113715	113741	lehtonen1910a	3	26
Ja itsepäinen se on kuin synti.	47272	47303	lehtonen1910a	5	31
Ja jalopeuroja siellä oli ollut.	455997	456029	lehtonen1910a	4	32
Ja järven selkä sohisee yhä aamu-unisesti.	18187	18229	lehtonen1910a	5	42
Ja Jöije alkoi kertoa.	59942	59964	jarnefelt1916a	3	22
Ja joka kerta enemmän.	89537	89559	pakkala1895a	3	22
Ja Jopi katselee Muttiseen kummallisesti.	665693	665734	lehtonen1910a	4	41
Ja Jopi, että hän on limppuhiiri.	495321	495354	lehtonen1910a	5	33
Ja joskus kalahtaa kello alakuloisesti.	731891	731930	lehtonen1910a	4	39
Ja joskus maistuvat mällit vaihteeksi mukavilta.	157453	157501	lehtonen1910a	5	48
Ja Jumalan kesä kaunis.	318761	318784	lehtonen1910a	3	23
Ja juokseminen raukaisee kovasti Malakiasta.	175717	175761	lehtonen1910a	4	44
Ja Juutas alkaa jälleen soutaa.	182938	182969	lehtonen1910a	4	31
Ja Juutas alkaa soutaa.	178733	178756	lehtonen1910a	3	23
Ja Juutashan se osaakin tarinoida.	750685	750719	lehtonen1910a	4	34
Ja kädet vapisivat.	170427	170446	canth1886a	2	19
Ja kahviakin hän on siellä odottanut.	98414	98451	lehtonen1910a	5	37
Ja kaikkea ennustelee?	349876	349898	lehtonen1910a	2	22
Ja kaikki lait, esi-isien aikuiset.	691275	691310	lehtonen1910a	4	35
Ja kaikki muutkin olivat niin ystävällisiä.	103596	103639	pakkala1895a	5	43
Ja kaikki on siitä silloin pahaa.	48871	48904	lehtonen1910a	5	33
Ja kaiku huutaa.	85036	85052	lehtonen1910a	2	16
Ja kaivellut louhiakin.	636650	636673	lehtonen1910a	2	23
Ja kapuavat kalliolle.	611327	611349	lehtonen1910a	2	22
Ja Karell sen ansaitsee.	142462	142486	canth1886a	3	24
Ja karkuun he aikoivat.	794943	794966	lehtonen1910a	3	23
Ja kärsällään se töhi lastuja.	202776	202806	lehtonen1910a	4	30
Ja kas, ruiskukkia.	612687	612706	lehtonen1910a	2	19
Ja käskee laulamaan.	502342	502362	lehtonen1910a	2	20
Ja katselee ympärilleen.	781000	781024	lehtonen1910a	2	24
Ja katso, jalasta vuotaa häneltä verta.	539351	539390	lehtonen1910a	5	39
Ja kengät valkeat niinkuin liitu.	132827	132860	lehtonen1910a	4	33
Ja kiikkuneet olivat korkealla katon rajassa.	455951	455996	lehtonen1910a	5	45
Ja kiiruhtaa saunalle.	743869	743891	lehtonen1910a	2	22
Ja kipeän jalan pohjetta pakottaa.	378760	378794	lehtonen1910a	4	34
Ja koetan väkisin ummistaa silmäni.	2581	2616	jarnefelt1913a	4	35
Ja kolmannen perpentikkelille.	792618	792648	lehtonen1910a	2	30
Ja komentelisi illalla maata.	409101	409130	lehtonen1910a	3	29
Ja Könölinin jäljestä kiiruhtaa emäntäneiti.	362906	362950	lehtonen1910a	4	44
Ja konttoristi oli hymyillyt.	97208	97237	lehtonen1910a	3	29
Ja korpinrasvaa sopisi koettaa.	360597	360628	lehtonen1910a	3	31
Ja körttiröijynsä, joka kuvastaa vyötäröt hoikkina.	547712	547763	lehtonen1910a	5	51
Ja kuinka käy koko maailmalle.	51761	51791	lehtonen1910a	4	30
Ja kuinkapa ihminen rakastaisi toisen maata.	785707	785751	lehtonen1910a	5	44
Ja kuitenkin paljon enemmän kuin kihloissa.	55108	55151	jarnefelt1916a	5	43
Ja kuitenkin vaivainen petäjä elää.	2246	2281	lehtonen1910a	4	35
Ja kuljettavat tänne kaikenmoisia irtolaisia.	780283	780328	lehtonen1910a	4	45
Ja kummitus meni saunan taakse.	417957	417988	lehtonen1910a	4	31
Ja kuolleen vuoteen juuri.	113533	113559	lehtonen1910a	3	26
Ja kurkisteli navetalle.	388358	388382	lehtonen1910a	2	24
Ja Kuula on juovuksissa.	92086	92110	jarnefelt1913a	3	24
Ja kuuleepa Käkriäinen sitten muutakin.	404985	405024	lehtonen1910a	4	39
Ja kuulkaa.	42116	42127	pakkala1895a	1	11
Ja kuuluivat keskenään nauravankin.	339421	339456	lehtonen1910a	3	35
Ja kuvastuvat veteen kuin mitkäkin untuvat.	390257	390300	lehtonen1910a	5	43
Ja kyllä minä aina sanasen keksin.	795341	795375	lehtonen1910a	5	34
Ja kyllä silloin pistää suunsa metiseksi.	300491	300532	lehtonen1910a	5	41
Ja kyllä täällä rahaa tarvitaan.	42125	42157	lehtonen1910a	4	32
Ja lampaita on.	65837	65852	lehtonen1910a	2	15
Ja langon puolelta, ystävän muka.	501345	501378	lehtonen1910a	4	33
Ja lapsiaan hän siinä huutelee.	200548	200579	lehtonen1910a	4	31
Ja lapsistahan se pitääkin.	57156	57183	lehtonen1910a	3	27
Ja lataa uutta.	381459	381474	lehtonen1910a	2	15
Ja lauhkea niinkuin mesi.	659398	659423	lehtonen1910a	3	25
Ja laulaa, laulaa.	68537	68555	lehtonen1910a	2	18
Ja leipä on Putkinotkossa lopussa.	380479	380513	lehtonen1910a	4	34
Ja Leistén on ollut oikein vihainen.	191215	191251	canth1886a	5	36
Ja Lejakin rauhoittaa vanhinta veljeään.	726011	726051	lehtonen1910a	4	40
Ja Lejalla sekä Jopilla.	315663	315687	lehtonen1910a	3	24
Ja liikkumattomuus, ja äänettömyys.	116488	116523	canth1886a	3	35
Ja Liisa oli kaikista alakuloisin.	69481	69515	pakkala1895a	4	34
Ja loppuvat eväät pennuilta.	95834	95862	lehtonen1910a	3	28
Ja lotjatöillä se on velkansa maksanut.	366226	366265	lehtonen1910a	5	39
Ja louhiselle mäelle.	500734	500755	lehtonen1910a	2	21
Ja luita kolottaa, ja päähän pistelee.	687401	687439	lehtonen1910a	5	38
Ja Luukas, mitä se pikkuinen itkee?	520594	520629	lehtonen1910a	5	35
Ja lystiä koetettiin pitää minulle.	449908	449943	lehtonen1910a	4	35
Ja maha pullottaa, oikea herran maha.	548368	548405	lehtonen1910a	5	37
Ja makea on sillekin, hyväkkäälle.	548748	548782	lehtonen1910a	4	34
Ja makeaa se on, tuulaskala.	691600	691628	lehtonen1910a	4	28
Ja Malakiaksella oli.	566621	566642	lehtonen1910a	2	21
Ja Malakias joutaa löylynlyöjäksi.	695234	695268	lehtonen1910a	3	34
Ja Malakias rupesi juoksemaan linnun perästä.	172949	172994	lehtonen1910a	5	45
Ja Malakias?	511842	511854	lehtonen1910a	1	12
Ja Martti oli heidät pelastanut.	84562	84594	jarnefelt1916a	4	32
Ja Martti, mitä hän teki?	253440	253465	jarnefelt1916a	4	25
Ja Mauno joutuu uudestaan rautoihin.	506697	506733	lehtonen1910a	4	36
Ja Mauno puhuukin hiljemmin.	490869	490897	lehtonen1910a	3	28
Ja Maunon Perttakin röijyä päälleen pujotellen.	743657	743704	lehtonen1910a	5	47
Ja Maunon piti lähteä.	293705	293727	lehtonen1910a	3	22
Ja meillä on niin vaikeata.	161760	161787	canth1886a	4	27
Ja menee ylös kalliolle ja petäjikköön.	125738	125777	lehtonen1910a	5	39
Ja meneepä puolikin tuntia.	203849	203876	lehtonen1910a	3	27
Ja meneepä siitä ylitse.	500888	500912	lehtonen1910a	3	24
Ja mihinkäs se Malakias on mennyt?	76122	76156	lehtonen1910a	5	34
Ja mikäs tämä haju sitten olikaan?	583238	583272	lehtonen1910a	5	34
Ja miksikä ei jo heti?	306293	306315	lehtonen1910a	4	22
Ja miksikä tekisi?	75443	75461	kilpi1903a	2	18
Ja minä huokasin kevennyksestä.	62065	62096	jarnefelt1913a	3	31
Ja minä kun tahtoisin heidän ystävyyttään.	776562	776604	lehtonen1910a	5	42
Ja minä kuulin heidän välisensä keskustelun.	103982	104026	jarnefelt1916a	5	44
Ja minä vain jauhoin ja jauhoin.	42860	42892	jarnefelt1916a	5	32
Ja minkälaista täällä oli viime talvena.	627098	627138	lehtonen1910a	5	40
Ja minun on keitettävä varikkoa.	303225	303257	lehtonen1910a	4	32
Ja missä ovat kaikki muut sanikat?	511926	511960	lehtonen1910a	5	34
Ja missä se Juutas on?	694579	694601	lehtonen1910a	4	22
Ja missäs nyt ihmiset?	385500	385522	lehtonen1910a	3	22
Ja mistä lienee tullut?	415738	415761	lehtonen1910a	3	23
Ja mitä hän tällaiseen?	745549	745572	lehtonen1910a	3	23
Ja mitä he sillä tiedolla tekisivät.	141458	141494	lehtonen1910a	5	36
Ja mitä pahaa siinä oikeastaan oli?	151279	151314	canth1886a	5	35
Ja mitä se oikeastaan minuun koskee?	91746	91782	jarnefelt1913a	5	36
Ja mitä se tavaroiden kantaminen maksaa?	596767	596807	lehtonen1910a	5	40
Ja mitä sinä hänelle aiot?	781447	781473	lehtonen1910a	4	26
Ja mitä?	427148	427156	lehtonen1910a	1	8
Ja mitähän Muttinen selityksellään tarkoittaa?	718983	719029	lehtonen1910a	4	46
Ja mitähän se Aapeli Juutaksesta?	707763	707796	lehtonen1910a	4	33
Ja mitähän se emäntäneiti mekastaa?	344129	344164	lehtonen1910a	4	35
Ja mitäpä neidin lepertelyistä: teeskentelee.	552968	553013	lehtonen1910a	4	45
Ja mitäs se herrassyötinki siihen?	621333	621367	lehtonen1910a	4	34
Ja mitäs: jo parani pöhötys jalasta.	719691	719727	lehtonen1910a	5	36
Ja mitenkä hän olisi täyttänyt?	28824	28855	lehtonen1910a	4	31
Ja mitenkäs hän?	751674	751690	lehtonen1910a	2	16
Ja molemmat alkoivat viskellä kivillä.	67617	67655	pakkala1895a	4	38
Ja morotit, minä sanon, hahaa.	150811	150841	lehtonen1910a	4	30
Ja muidenkin pentujen olevan vielä kotona.	200069	200111	lehtonen1910a	5	42
Ja muut lehmät ajakaa metsään.	425260	425290	lehtonen1910a	4	30
Ja muut pojat.	694564	694578	lehtonen1910a	2	14
Ja muut.	645171	645179	lehtonen1910a	1	8
Ja muuta ei nytkään tarvittu.	130860	130889	jarnefelt1916a	4	29
Ja muuta, heh.	596511	596525	lehtonen1910a	2	14
Ja myös yhtä notkea ja siro.	92191	92219	jarnefelt1916a	5	28
Ja naivansa on hän vannoskellut Sanelman.	793879	793920	lehtonen1910a	5	41
Ja näkeehän mies ajan viisarit auringostakin.	409177	409222	lehtonen1910a	5	45
Ja näkyy tuosta jyvääkin tulevan.	476187	476220	lehtonen1910a	4	33
Ja nälkä uhkaa.	53735	53750	lehtonen1910a	2	15
Ja narrasi sitä miestään, nuorena vaimona.	322272	322314	lehtonen1910a	5	42
Ja nätti se onkin.	290013	290031	lehtonen1910a	3	18
Ja nauraa kirkkain äänin.	68480	68505	lehtonen1910a	3	25
Ja nauroi.	360815	360825	lehtonen1910a	1	10
Ja ne alkamattomat puuskat ovat pitkiä.	47528	47567	lehtonen1910a	5	39
Ja ne ovat kauniita kuin paperikukat.	283144	283181	lehtonen1910a	5	37
Ja ne tekevät sinne omia laitoksiaan.	504268	504305	lehtonen1910a	5	37
Ja neuvomaan niitä töihin, isompia niistä.	200940	200982	lehtonen1910a	5	42
Ja niiden takana kiiluu saarinen ulappa.	611862	611902	lehtonen1910a	5	40
Ja niillä on siellä sianporsas mukana.	201813	201851	lehtonen1910a	5	38
Ja niin erinomaisen lämmin nyt on.	116674	116708	canth1886a	5	34
Ja niin he menivät uudestaan kaupungille.	25902	25943	pakkala1895a	5	41
Ja niin kaunis peitekin.	107322	107346	pakkala1895a	3	24
Ja niin kävi joka talossa.	50801	50827	pakkala1895a	4	26
Ja niin koko maailmaa.	784481	784503	lehtonen1910a	3	22
Ja niin märkänevät mahassakin.	150143	150173	lehtonen1910a	3	30
Ja niin olikin.	35897	35912	jarnefelt1916a	2	15
Ja niin olikin.	145380	145395	jarnefelt1916a	2	15
Ja niin sanoin sille herrallekin, insinöörille.	301500	301547	lehtonen1910a	5	47
Ja niinhän sillä olikin.	309631	309655	lehtonen1910a	3	24
Ja noin ruskea.	542284	542299	lehtonen1910a	2	15
Ja nukkui taas pitkään.	125522	125545	pakkala1895a	3	23
Ja nuo saaret siellä ikäänkuin uivat.	390185	390222	lehtonen1910a	5	37
Ja nyt alkaa Putkinotkossa komento.	422415	422450	lehtonen1910a	4	35
Ja nyt hänen sydämensä hätkähtää.	154276	154309	lehtonen1910a	4	33
Ja nyt he antavat Putkinotkon rappeutua.	779980	780020	lehtonen1910a	5	40
Ja nyt on kiirein heinäaika.	285774	285802	lehtonen1910a	4	28
Ja nyt se tulee Juutaksen perästäkin.	499260	499297	lehtonen1910a	5	37
Ja nyt seurasi pitkä yö.	100026	100050	lassila1910a	4	24
Ja nytkös tuli kiire.	273108	273129	jarnefelt1916a	3	21
Ja oikea silmä katseli humaliston juurelle.	168274	168317	lehtonen1910a	5	43
Ja oikein kauniita marjoja.	86559	86586	pakkala1895a	3	27
Ja oikeutettuakin Jumalan rangaistusta se olisi.	279351	279399	lehtonen1910a	5	48
Ja oksien rapinaa saunan päätyseinään.	663595	663633	lehtonen1910a	4	38
Ja olen neuvonut.	779116	779133	lehtonen1910a	2	17
Ja oli paljon lupaillut.	57008	57032	lehtonen1910a	3	24
Ja oli toivonut, että he vaurastuisivat.	661721	661761	lehtonen1910a	5	40
Ja olipa itse pompommiherrakin.	737852	737883	lehtonen1910a	3	31
Ja olisi annettu miten paljon tahansa.	448063	448101	lehtonen1910a	5	38
Ja on isäkin alkanut vihjailla.	230216	230247	lehtonen1910a	4	31
Ja on muutakin.	195895	195910	lehtonen1910a	2	15
Ja on niitä ollut käärmeitä minussakin.	713120	713159	lehtonen1910a	5	39
Ja onhan kielletty homma jokaisesta makeaa.	662973	663016	lehtonen1910a	5	43
Ja onhan kuoppa täynnä perunoita.	48190	48223	lehtonen1910a	4	33
Ja onhan niitä täällä taloissakin.	770714	770748	lehtonen1910a	4	34
Ja onhan se totta.	466906	466924	lehtonen1910a	3	18
Ja onkia, sormenpituisia ahvenia, hihii.	246964	247004	lehtonen1910a	4	40
Ja onkin asiassa monet mutkat.	482998	483028	lehtonen1910a	4	30
Ja onko Juutas tullut jo myllyltä?	424341	424375	lehtonen1910a	5	34
Ja osanneeko tuo haastella, kala?	691473	691506	lehtonen1910a	4	33
Ja ovessa tullessaan hän pyyhki otsaansa.	139828	139869	canth1886a	5	41
Ja pahemminkin: heidän mielialansa meikäläistä kohtaan.	768164	768219	lehtonen1910a	5	55
Ja paitsi sardiineita on oikein hummereita.	601320	601363	lehtonen1910a	5	43
Ja pakenee aidan luota kiireesti pois.	99667	99705	lehtonen1910a	5	38
Ja paljon toivoivat he saavansa.	91320	91352	pakkala1895a	4	32
Ja panee poliisit viinoistakin ahdistamaan.	302213	302256	lehtonen1910a	4	43
Ja pelästyy.	124928	124940	lehtonen1910a	1	12
Ja pentuja.	506191	506202	lehtonen1910a	1	11
Ja Pertta Kinnusella kanssa?	494346	494374	lehtonen1910a	3	28
Ja pesemään tullaan herraa.	693929	693956	lehtonen1910a	3	27
Ja pieksää kädellään.	507559	507580	lehtonen1910a	2	21
Ja pieni vuona mäkättää valittavasti.	689266	689303	lehtonen1910a	4	37
Ja pienistä on kasvatettu.	458082	458108	lehtonen1910a	3	26
Ja piippuaan rassaten.	73779	73801	lehtonen1910a	2	22
Ja piippukin kädessä vapisee.	101682	101711	lehtonen1910a	3	29
Ja piipun piki on hyvä hampaankolotukseen.	214260	214302	lehtonen1910a	5	42
Ja piirongit tytöille.	390536	390558	lehtonen1910a	2	22
Ja pikku Luukas on kehdossa.	326943	326971	lehtonen1910a	4	28
Ja pilkata.	273537	273548	lehtonen1910a	1	11
Ja pitäisi ostaa uusi hevonen.	65853	65883	lehtonen1910a	4	30
Ja pitäköön kemut Juutas.	787909	787934	lehtonen1910a	3	25
Ja pitelemään Poikaa kujan suussa.	678696	678730	lehtonen1910a	4	34
Ja poikain silmät hän pesi.	36689	36716	canth1886a	4	27
Ja polvet hiukan tutisevat.	376021	376048	lehtonen1910a	3	27
Ja puhalsi kynttilän sammuksiin.	134474	134506	canth1886a	3	32
Ja puhdas tuli.	275946	275961	lehtonen1910a	2	15
Ja puhkesin onneni täyteen kukoistukseen.	40171	40212	jarnefelt1913a	4	41
Ja puhuinkin siitä komesrootille.	345060	345093	lehtonen1910a	3	33
Ja pujahtaa matalasta ovesta aittaan.	104422	104459	lehtonen1910a	4	37
Ja puolella hintaa?	370005	370024	lehtonen1910a	2	19
Ja puutarhani rappiolla.	773108	773132	lehtonen1910a	2	24
Ja raapisivat itseään raivoisasti.	17745	17779	lehtonen1910a	3	34
Ja rahaa lähtikin Käkriäiselle.	94633	94664	lehtonen1910a	3	31
Ja rahtaamaan pataa kodasta.	188145	188173	lehtonen1910a	3	28
Ja rakastaapa hän kuitenkin pohjaltaan lapsiaan.	161323	161371	lehtonen1910a	5	48
Ja rauhallista, hiljaista, kodikasta.	133809	133846	canth1886a	3	37
Ja Repekka alkaa huutaa.	725414	725438	lehtonen1910a	3	24
Ja Repekkakin rupeaa väkisin tempomaan.	434747	434786	lehtonen1910a	4	39
Ja retkuväet.	150360	150373	lehtonen1910a	1	13
Ja Ripatti olisi tahtonut melkeinpä ilmaiseksi.	342993	343040	lehtonen1910a	5	47
Ja romaanilla olisi ollut arvokas alkunsa.	10200	10242	jarnefelt1916a	5	42
Ja röpöteistä sai oikein mukavaa ruokaa.	143002	143042	lehtonen1910a	5	40
Ja Rosina huokaisee.	32928	32948	lehtonen1910a	2	20
Ja rotakolla menee.	234416	234435	lehtonen1910a	2	19
Ja rouhaista oikein sylin täydeltä.	462406	462441	lehtonen1910a	4	35
Ja ruokakonttorinsa ja aittansa ja riihensä.	411985	412029	lehtonen1910a	5	44
Ja ruokalystin se antaa.	666162	666186	lehtonen1910a	3	24
Ja rupea ihan heti, viimeinkin.	308104	308135	lehtonen1910a	4	31
Ja rupesi hiljaa itkemään.	292653	292679	jarnefelt1916a	3	26
Ja rupesi nousemaan ikäänkuin lähteäkseen.	251724	251766	jarnefelt1916a	4	42
Ja rupesi nyyhkyttämään.	741483	741507	lehtonen1910a	2	24
Ja rutto kuolema.	716173	716190	lehtonen1910a	2	17
Ja ruumis jäässä.	676893	676910	lehtonen1910a	2	17
Ja ryntäsi rannemmaksi.	623585	623608	lehtonen1910a	2	23
Ja Saara yökötteleiksen.	182307	182331	lehtonen1910a	2	24
Ja saarnaamaan korpijoonin myymisestäkin.	707135	707176	lehtonen1910a	3	41
Ja sähkösytytyksellä se käy.	530525	530553	lehtonen1910a	3	28
Ja säikähti uudelleen niin, että vavahti.	61212	61253	pakkala1895a	5	41
Ja saisi sen polttimon jonnekin kätköön.	187195	187235	lehtonen1910a	5	40
Ja salasin kaikki.	66826	66844	jarnefelt1913a	2	18
Ja saliin vietiin, toppatuoliin istutettiin.	449863	449907	lehtonen1910a	4	44
Ja samalla alkavat airot soutaa.	790552	790584	lehtonen1910a	4	32
Ja samalla häntä ikään kuin kiukuttaa.	462235	462273	lehtonen1910a	5	38
Ja Sanelma lähtee Lejan kanssa.	427976	428007	lehtonen1910a	4	31
Ja Sanelma sanoo paistavansa ahveniakin.	664477	664517	lehtonen1910a	4	40
Ja sanoin näyttäväni hänelle takapompelini.	301548	301591	lehtonen1910a	4	43
Ja satakertoja.	452218	452233	lehtonen1910a	1	15
Ja se hohde muuttuu yhä keltaisemmaksi.	626565	626604	lehtonen1910a	5	39
Ja se ihmetyttää Käkriäistä.	564537	564565	lehtonen1910a	3	28
Ja se kaipuu kasvatti runkoni.	38417	38447	jarnefelt1913a	4	30
Ja se keitetään.	311041	311057	lehtonen1910a	2	16
Ja se nautitaan sisällisesti.	716266	716295	lehtonen1910a	3	29
Ja se nousi ja nousi.	283511	283532	jarnefelt1916a	4	21
Ja se oli iltahämärä, melkeinpä pimeä.	95400	95438	lehtonen1910a	5	38
Ja se olikin käärme.	714318	714338	lehtonen1910a	3	20
Ja se on jälleen puutteen lisä.	745235	745266	lehtonen1910a	5	31
Ja se on tässä ratkaisevaa.	261071	261098	jarnefelt1916a	4	27
Ja se riittikin vuosiksi.	775292	775317	lehtonen1910a	3	25
Ja se säkki, säkki.	386306	386325	lehtonen1910a	3	19
Ja se suututtaa Juutasta.	483611	483636	lehtonen1910a	3	25
Ja se tapailee jo kiekon muotoa.	577171	577203	lehtonen1910a	5	32
Ja se tuntui niin hauskalle.	39464	39492	pakkala1895a	4	28
Ja se vastauskos ärsyttää Juutasta.	92128	92163	lehtonen1910a	4	35
Ja sekaan collodiumia.	277079	277101	lehtonen1910a	2	22
Ja selitän.	150651	150662	lehtonen1910a	1	11
Ja sen auttamisen ne ihmiset muistavat.	113801	113840	lehtonen1910a	5	39
Ja sen henki löyhkää vähän väkeville.	277864	277901	lehtonen1910a	5	37
Ja sen jälkeen lähtee jono rannalle.	163624	163660	lehtonen1910a	5	36
Ja sen neidinkin perässä.	545609	545634	lehtonen1910a	3	25
Ja sen on pullea Aapeli tehnyt.	586895	586926	lehtonen1910a	5	31
Ja sentähdenkö sitä aina nukuttaneekin.	75674	75713	lehtonen1910a	4	39
Ja siellä on myöskin Topi.	512109	512135	lehtonen1910a	4	26
Ja siellä rupesin laulamaan.	301256	301284	lehtonen1910a	3	28
Ja sieraimiinkin hiki tunkeutuu.	382051	382083	lehtonen1910a	3	32
Ja siihen luottivat toisetkin.	96228	96258	pakkala1895a	3	30
Ja siihenpä koko onneni sisältyykin.	156288	156324	jarnefelt1916a	4	36
Ja siinä tahraa itsensä.	603498	603522	lehtonen1910a	3	24
Ja siitä oli jo kauan.	29780	29802	pakkala1895a	4	22
Ja sillä oli korvat päässä, punaiset.	217227	217264	lehtonen1910a	5	37
Ja silloin ei hän enää malttanut.	11012	11045	lassila1910a	5	33
Ja silloin miehen vimma yhä kiihtyy.	102428	102464	lehtonen1910a	5	36
Ja silloin tulee hänen ilmeensä iloisemmaksi.	543541	543586	lehtonen1910a	5	45
Ja silloin tulee uutta viljaakin.	487057	487090	lehtonen1910a	4	33
Ja sinä, Jopi, ota tuo nyytti.	160503	160533	lehtonen1910a	5	30
Ja sinunhan olisi katseltava raja-aitoja.	604146	604187	lehtonen1910a	4	41
Ja sitähän minä itkin.	120217	120239	canth1886a	3	22
Ja sitäpaitsi on Rosina vahva.	102757	102787	lehtonen1910a	4	30
Ja sitten ajetaan kätkyellä uunia kohti.	681334	681374	lehtonen1910a	5	40
Ja sitten Ananias unohtaa koko ampumisen.	795940	795981	lehtonen1910a	5	41
Ja sitten hän kalpeni.	79433	79455	lehtonen1910a	3	22
Ja sitten hän kellahtaa loikomaan.	700077	700111	lehtonen1910a	4	34
Ja sitten hänen kuitenkin täytyi kertoa.	119796	119836	canth1886a	5	40
Ja sitten jättäisi polttamisen.	188023	188054	lehtonen1910a	3	31
Ja sitten kaikuu karjapihasta Rosinan ääni.	457469	457512	lehtonen1910a	5	43
Ja sitten Käkriäinen pukeutui parempiinsa.	50791	50833	lehtonen1910a	4	42
Ja sitten kuuluu myöskin Jopin puhelua.	471848	471887	lehtonen1910a	5	39
Ja sitten louhien koloon mäyrien luokse.	780140	780180	lehtonen1910a	5	40
Ja sitten maannut.	94031	94049	lehtonen1910a	2	18
Ja sitten Malakias lähteekin hakemaan saunapuita.	655307	655356	lehtonen1910a	5	49
Ja sitten ne äkkiä taas kirkastuivat.	234470	234507	canth1886a	5	37
Ja sitten ne lähtevätkin naurahtelemasta.	259969	260010	lehtonen1910a	4	41
Ja sitten on hän tuokion vaiti.	147155	147186	lehtonen1910a	5	31
Ja sitten on näkynyt kaupunki.	239214	239244	lehtonen1910a	4	30
Ja sitten pienillä-pienillä hakasilla sidon itseeni.	43196	43248	jarnefelt1913a	5	52
Ja sitten Putkinotkon mökki.	505525	505553	lehtonen1910a	3	28
Ja sitten Repekka nauraa kirkkain silmin.	132038	132079	lehtonen1910a	5	41
Ja sitten se alkaa, se löylytys.	701055	701087	lehtonen1910a	5	32
Ja sitten teki mekot lapsille.	249441	249471	lehtonen1910a	4	30
Ja sitten Topi Sanelmaa.	227812	227836	lehtonen1910a	3	24
Ja sitten tuli viimekesäisestä naurusta itku.	741752	741797	lehtonen1910a	5	45
Ja sittenkös se oli alkanut juosta.	202226	202261	lehtonen1910a	5	35
Ja sivistyisivätkin.	661762	661782	lehtonen1910a	1	20
Ja Sohvi.	386296	386305	lehtonen1910a	1	9
Ja sotaväen musiikki otetaan matkaan.	179915	179952	canth1886a	4	37
Ja sukat olivat kauniit.	110341	110365	pakkala1895a	3	24
Ja suoraa kuin nuoraa, hihii.	427279	427308	lehtonen1910a	4	29
Ja suostuu antamaan toisellekin osuutensa, Maunolle.	638266	638318	lehtonen1910a	5	52
Ja syömään mukavammin.	661838	661860	lehtonen1910a	2	22
Ja syömistä muulloinkin kuin ihmisten ruoka-aikoina.	119339	119391	lehtonen1910a	5	52
Ja täällä on metsiä.	485471	485491	lehtonen1910a	3	20
Ja taas ärjyy hän Topille.	210213	210239	lehtonen1910a	4	26
Ja taas muistui mieleen kaivovesi.	289399	289433	lassila1910a	4	34
Ja tähdet välkkyvät.	6054	6074	lehtonen1910a	2	20
Ja talvella ne kaalit märkänevät kuopassa.	207851	207893	lehtonen1910a	5	42
Ja tanssia.	230353	230364	lehtonen1910a	1	11
Ja tapaako Perttaa Potamian puolella.	286041	286078	lehtonen1910a	4	37
Ja tapella, juoda miesten kanssa.	472866	472899	lehtonen1910a	4	33
Ja tappaa pentunsa ja kaikki.	503940	503969	lehtonen1910a	4	29
Ja taputtaa Esteriä poskelle.	554092	554121	lehtonen1910a	3	29
Ja tarjoaapa Maunollekin vavahtavin käsin.	555649	555691	lehtonen1910a	4	42
Ja tätä tehdessään he lauleskelivat.	86193	86229	jarnefelt1913a	4	36
Ja täti on nukkunut.	466607	466627	lehtonen1910a	3	20
Ja täytyyhän Maunon koettaa auttaa sisartaan.	305515	305560	lehtonen1910a	5	45
Ja teidät valitsemme päälliköksi.	158936	158969	canth1886a	3	33
Ja tekisi sen luvattakin.	582060	582085	lehtonen1910a	3	25
Ja tietysti me aina maistelemme.	781859	781891	lehtonen1910a	4	32
Ja tietysti vilpitön.	771197	771218	lehtonen1910a	2	21
Ja tietysti yhäkin mustempia sieluntiloja kohden.	133050	133099	jarnefelt1916a	5	49
Ja todella kirjoitinkin.	136650	136674	jarnefelt1916a	2	24
Ja toiset selittivät käyneensä paljo edempänäkin.	102275	102324	pakkala1895a	5	49
Ja toisille tuli hirveä hätä.	90089	90118	pakkala1895a	4	29
Ja Topi.	511855	511863	lehtonen1910a	1	8
Ja Topikin on kadonnut.	164985	165008	lehtonen1910a	3	23
Ja toukojakin jouduttaa.	319548	319572	lehtonen1910a	2	24
Ja tuli ikävä tyttöjä ja kaikkia.	121781	121814	pakkala1895a	5	33
Ja tulisi siitä huolta.	649421	649444	lehtonen1910a	3	23
Ja tulkaa kaikki.	101879	101896	pakkala1895a	2	17
Ja tultakin sinne pitää kuljettaa.	695269	695303	lehtonen1910a	4	34
Ja tuo kauppias voi ruveta pilkalliseksi.	271075	271116	lehtonen1910a	5	41
Ja tuoleja sohvien välissä ja ympärillä.	329138	329178	lehtonen1910a	5	40
Ja tuolla on tupana laivan kajuutta.	289956	289992	lehtonen1910a	5	36
Ja tuollapa on Topikin, veräjän takana.	538750	538789	lehtonen1910a	5	39
Ja tuosta toisesta välistä ruumenet.	270490	270526	jarnefelt1916a	4	36
Ja tupa ihan hajallaan.	545790	545813	lehtonen1910a	3	23
Ja tupaa voisi kyllä lämmittää.	25555	25586	lehtonen1910a	4	31
Ja tuttiaan imevä Luukas nukkui.	225539	225571	lehtonen1910a	4	32
Ja tynnöri.	184674	184685	lehtonen1910a	1	11
Ja Ulla oli mahtava puolestaan.	88533	88564	pakkala1895a	4	31
Ja usein sainkin tietää jotain lisäksi.	60946	60985	jarnefelt1916a	5	39
Ja usein se siinä kiihtyy.	48844	48870	lehtonen1910a	4	26
Ja uusi huutokin jähmettyy hänelle kurkkuun.	154406	154450	lehtonen1910a	5	44
Ja uusia kuvitteluita tulee.	589619	589647	lehtonen1910a	3	28
Ja vähitellen se hiukan selvenee.	657578	657611	lehtonen1910a	4	33
Ja vaikeni auttamattomasti.	246867	246894	jarnefelt1916a	2	27
Ja vaikka kätkössä olisi raatoja.	799016	799049	lehtonen1910a	4	33
Ja vapisutti kovin.	23669	23688	canth1886a	2	19
Ja varpaat ovat venyneet hirmuisen pitkiksi.	40404	40448	lehtonen1910a	5	44
Ja varsa vavahti lähteäkseen.	131365	131394	jarnefelt1913a	3	29
Ja varsinkin joitakin kivimuureja.	128043	128077	lehtonen1910a	3	34
Ja varsinkin metsäläinen on itsepäinen.	662933	662972	lehtonen1910a	4	39
Ja vedestä nousee usvaa.	11411	11435	lehtonen1910a	3	24
Ja vehnästä on.	447333	447348	lehtonen1910a	2	15
Ja veisaa joskus Mauno-enon Perttakin.	128287	128325	lehtonen1910a	4	38
Ja vetää päätä ikäänkuin makuulle.	503550	503584	lehtonen1910a	4	34
Ja viedä sinne järvelle.	156011	156035	lehtonen1910a	3	24
Ja vielä toisen kerran hän laukaisee.	789655	789692	lehtonen1910a	5	37
Ja vielä toisen, toiselle jalalle.	792583	792617	lehtonen1910a	4	34
Ja viiltää itselleen leivänkannikasta paksun palasen.	142700	142753	lehtonen1910a	5	53
Ja viimein lampun.	791064	791082	lehtonen1910a	2	18
Ja viinatkin ovat talosta loppuneet.	52426	52462	lehtonen1910a	4	36
Ja yhä Kenkkuinniemen päätä kohti.	500796	500830	lehtonen1910a	4	34
Ja yhä tuskaisemmin kyhnyttää Jopikin äitiään.	441924	441970	lehtonen1910a	5	46
Ja yhtäkkiä tulee ruispellon aidan nurkkaus.	612447	612491	lehtonen1910a	5	44
Ja ylenkatseellisesti hän heille nauroi.	340065	340105	lehtonen1910a	4	40
Jää vaan risahti, ei murtunutkaan.	126076	126110	jarnefelt1913a	4	34
Jaa, jaa, keske sisälle.	99500	99524	jarnefelt1913a	3	24
Jaakko oli kiihtyä.	2415	2434	pakkala1895a	2	19
Jaakko seisoi silmänräpäyksen ajan tyrmistyneenä.	3066	3115	pakkala1895a	4	49
Jäät ovat lähteneet vesistä.	6089	6117	lehtonen1910a	3	28
Jag är förlorad, Tyyne.	102254	102277	jarnefelt1913a	3	23
Jag måste anmäla saken.	102745	102768	jarnefelt1913a	3	23
Jaha, vai et tiedä.	596935	596954	lehtonen1910a	3	19
Jäikös, Jöije?	292017	292031	jarnefelt1916a	1	14
Jalkoja jäykistää ja varpaat tulevat punaisiksi.	58730	58778	lehtonen1910a	5	48
Jälleen on kaikki hyvä.	562697	562720	lehtonen1910a	3	23
Järvessä kuultaa monenmuotoisia pilviä.	181084	181123	lehtonen1910a	3	39
Jätin siihen viimeisetkin yritykseni.	247727	247764	jarnefelt1916a	3	37
Jättää Maria Martolan yksikseen.	109282	109314	jarnefelt1913a	3	32
Jauhoja on valunut terävän koivukannon juureen.	383075	383122	lehtonen1910a	5	47
Jauhot antoi.	451908	451921	lehtonen1910a	1	13
Jo ennestään on rähissyt sinulle.	492785	492818	lehtonen1910a	4	33
Jo heittäysi rekeen.	131343	131363	jarnefelt1913a	2	20
Jo johan siitä Joillakin tiesivät puhua.	178192	178232	lassila1910a	5	40
Jo kuumottaa heinälatokin harmaan aidan vierestä.	59202	59251	lehtonen1910a	5	49
Jo minä joudun epätoivoon.	141484	141510	canth1886a	3	26
Jo näkyvissä ollessa silpasi Maija edelle.	14331	14373	pakkala1895a	5	42
Jo nyt parkaisi ja töyttäsi päin.	35563	35596	canth1886a	5	33
Jo on iltapuoli pitkällä.	510763	510788	lehtonen1910a	3	25
Jo on luona.	131330	131342	jarnefelt1913a	2	12
Jo örähtää Juutas vastaan.	156234	156260	lehtonen1910a	3	26
Jo seuraavana aamuna on rietta poissa.	34363	34401	lehtonen1910a	5	38
Jo tahtoivat kädet raueta.	62197	62223	lassila1910a	3	26
Jo tänä päivänä, tänä päivänä.	310979	311009	lehtonen1910a	4	30
Jo tulee mustalle jäälle.	131173	131198	jarnefelt1913a	3	25
Jo tulee Rosina.	81640	81656	lehtonen1910a	2	16
Jo tuli yhden miehen osalle.	719893	719921	lehtonen1910a	4	28
Jo, jo ajoi Yömin pois.	678935	678958	lehtonen1910a	4	23
Johan minä olisin suorastaan naurettava.	266729	266769	jarnefelt1916a	4	40
Johan taas olemme liikkeellä.	3337	3366	jarnefelt1913a	3	29
John antaa teille vapaan vallan.	180165	180197	canth1886a	4	32
John ei häntä estänyt lähtemästä.	181729	181762	canth1886a	4	33
John hymyili.	153535	153548	canth1886a	1	13
John katsoi erästä kirjaa pöydällä.	178765	178800	canth1886a	4	35
John meni ja vei Tyysän mukanaan.	129685	129718	canth1886a	5	33
John meni kamariinsa.	178977	178998	canth1886a	2	21
John meni kamarin ovelle.	177973	177998	canth1886a	3	25
John nousi.	168756	168767	canth1886a	1	11
John peitti kädellä silmiään.	217686	217715	canth1886a	3	29
John rypisti hiukkasen otsaansa.	179396	179428	canth1886a	3	32
John sattui luomaan silmänsä verannalle.	148810	148850	canth1886a	4	40
John silitteli hänen päätään.	118871	118900	canth1886a	3	29
John vähän kummastellen häneen katsoi.	136686	136724	canth1886a	4	38
Johonkin kukolliseen taloon.	42054	42082	lehtonen1910a	2	28
Jöije ajatteli.	72072	72087	jarnefelt1916a	1	15
Jöije ei enää itkenyt.	194651	194673	jarnefelt1916a	3	22
Jöije ei kuitenkaan odottanut minun vastaavan.	292450	292496	jarnefelt1916a	5	46
Jöije ei suomea eikä poika ruotsia.	22616	22651	jarnefelt1916a	5	35
Jöije huiskuttaa nauraen kättä tervehdykseksi pihallaolijoille.	258189	258252	jarnefelt1916a	5	63
Jöije hymyili omissa ajatuksissaan, välittämättä vastata.	115301	115358	jarnefelt1916a	5	57
Jöije kuitenkin ymmärsi heti kaiken.	75778	75814	jarnefelt1916a	4	36
Jöije meni rantaan.	66556	66575	jarnefelt1916a	2	19
Jöije oli palannut iltajunassa.	20322	20353	jarnefelt1916a	3	31
Jöije rupesi nauramaan minun ällistykselleni.	55153	55198	jarnefelt1916a	4	45
Jöije tuli oikein alakuloiseksi näitä ajatellessaan.	83743	83795	jarnefelt1916a	5	52
Jöije tunsi itsensä peräti aseettomaksi.	83390	83430	jarnefelt1916a	4	40
Jöijesi.	163575	163583	jarnefelt1916a	0	8
Jöijesi.	169546	169554	jarnefelt1916a	0	8
Joka kerta tänne tullessaan.	564689	564717	lehtonen1910a	3	28
Joka kulmalta pitkin kangasta.	46364	46394	lehtonen1910a	3	30
Joka tapahtuikin.	190879	190896	jarnefelt1916a	1	17
Jokainoassa liikkeessä.	163506	163529	canth1886a	1	23
Jokeni ja puutarhani on minut pelastanut.	36476	36517	jarnefelt1913a	5	41
Jokin aavistus täytti mieleni.	253326	253356	jarnefelt1916a	3	30
Jokin kolahtaa saunan eteisessä.	674563	674595	lehtonen1910a	3	32
Jokin kuppi pitäisi edes olla.	138229	138259	lehtonen1910a	4	30
Joko köyhyydessään tai rupeaa sillä keinottelemaan.	785550	785601	lehtonen1910a	5	51
Joko lapikas nipistää?	493351	493373	lehtonen1910a	2	22
Joko nyt onnettomuuksia?	119891	119915	jarnefelt1916a	2	24
Joko se laiva tullee?	154635	154656	lehtonen1910a	3	21
Jokohan siellä laivan aallot liikkuvat?	154754	154793	lehtonen1910a	4	39
Joku aidas on lujassa.	383729	383751	lehtonen1910a	3	22
Joku alkaa kysellä: missä avain on?	1885	1920	jarnefelt1916a	5	35
Joku hakannut kirveellä jalkaans.	275286	275319	lehtonen1910a	3	33
Joku niistä muistuttaa istuvaa sammakkoa.	3574	3615	lehtonen1910a	4	41
Joku oli pistänyt peilinsirpaleen seinänrakoon.	273821	273868	jarnefelt1916a	4	47
Joku ostajista nauraa.	280351	280373	lehtonen1910a	2	22
Joku paimentyttö näki ja tietysti kertoi.	89220	89261	jarnefelt1916a	5	41
Jolle nyt kostan.	767329	767346	lehtonen1910a	2	17
Jolloin hänen päässään liehuivat kultaiset kiharat.	769335	769386	lehtonen1910a	5	51
Jonnekin hyvin kauas.	106493	106514	lehtonen1910a	2	21
Jopa se puhaltaa.	701664	701681	lehtonen1910a	2	17
Jopas nyt meni Topi.	519813	519833	lehtonen1910a	3	20
Jopas on Topi sinne kerinnyt.	208676	208705	lehtonen1910a	4	29
Jopi aikoo juosta Saaran perästä.	261695	261728	lehtonen1910a	4	33
Jopi höristää korviaan.	154252	154275	lehtonen1910a	2	23
Jopi huutaa.	85023	85035	lehtonen1910a	1	12
Jopi huuteli Malakiasta äsken rannalla.	165057	165096	lehtonen1910a	4	39
Jopi hyppää alas aidalta.	643532	643557	lehtonen1910a	3	25
Jopi istuu takapenkillä jalat riitissä allaan.	700426	700472	lehtonen1910a	5	46
Jopi juoksee kiireesti hänen kintereillään.	163788	163831	lehtonen1910a	4	43
Jopi kuuntelee tarkoin korvin, äitinsä takana.	257866	257912	lehtonen1910a	5	46
Jopi on niitä Topille luvannut.	432500	432531	lehtonen1910a	4	31
Jopi rauhoittuu.	155478	155494	lehtonen1910a	1	16
Jopi tähystelee, suojaten silmiään järven kiillolta.	153330	153382	lehtonen1910a	5	52
Jopi, työnnähän tupakkaa tuohon tupakkakukkaroon.	107385	107434	lehtonen1910a	4	49
Jopia viedään rannalle.	258295	258318	lehtonen1910a	2	23
Jopikin on valmis lähtöön.	695743	695769	lehtonen1910a	3	26
Jopiko kiusaa sinua?	82552	82572	lehtonen1910a	2	20
Jopin nappikengät kapisevat kujalla.	664619	664655	lehtonen1910a	3	36
Jos lähtisi kotiin?	412579	412598	lehtonen1910a	2	19
Jos lienevät olleet kultaa.	129272	129299	lehtonen1910a	3	27
Jos ne nyt niitä kaikille antavat.	272128	272162	lehtonen1910a	5	34
Jos pitää muustakin syystä: muuten vain.	374452	374492	lehtonen1910a	5	40
Jos ruvettaisiin hörräämään.	306234	306262	lehtonen1910a	2	28
Jos vielä hyvinkin vilkastuu.	446108	446137	lehtonen1910a	3	29
Joskus hän seisahtuu ja huutaa lehmiään.	57367	57407	lehtonen1910a	5	40
Joskus läiskähtää ongenkuppi veteen.	626660	626696	lehtonen1910a	3	36
Joskus menivät miehet kiireessä kuperkeikkaa.	112629	112674	lassila1910a	4	45
Joskus se tulee, se oikea into.	636529	636560	lehtonen1910a	5	31
Jostakin ne kuitenkin ostavat mieleistänsä.	186427	186470	lehtonen1910a	4	43
Jotain iloa tuosta lupittamisestakin on.	63267	63307	lehtonen1910a	4	40
Jotain uutta oli Martissa.	193278	193304	jarnefelt1916a	3	26
Joten Pertta nytkin saattaa olla tavattavissa.	286499	286545	lehtonen1910a	5	46
Joten siitä saa jouluna paljon läskiä.	202068	202106	lehtonen1910a	5	38
Joulukuun alussa oli pantu toimeen naamiaiset.	184872	184918	canth1886a	5	46
Juhlan ohjelmaan kuului seuranäytelmä.	162913	162951	canth1886a	3	38
Julmistuneelta näyttää Mauno.	492488	492517	lehtonen1910a	2	29
Jumala anteeksi antakoon.	322136	322161	lehtonen1910a	2	25
Jumala ei siis välitäkään marjoista?	85411	85447	pakkala1895a	4	36
Jumala, rakas isä, palkitkoon.	47966	47996	canth1886a	3	30
Juodaan nyt.	783301	783313	lehtonen1910a	1	12
Juohtui mieleen Partanenkin.	273808	273836	lassila1910a	2	28
Juostessa tuli helle.	155554	155575	lassila1910a	2	21
Juovathan ne herrat.	277902	277922	lehtonen1910a	2	20
Jussi alkoi hieroa.	43337	43356	lassila1910a	2	19
Jussi ällistyi, ja ällistyi siinä kuulustelijakin.	239071	239121	lassila1910a	5	50
Jussi odotti.	146797	146810	lassila1910a	1	13
Jussi oli siihen erittäin halukas.	114245	114279	lassila1910a	4	34
Jussi yritti silloin tekeytyä ystäväksi.	66383	66423	lassila1910a	4	40
Jussilla oli paha omatunto.	274510	274537	lassila1910a	3	27
Jussin mitta oli täysi.	134669	134692	lassila1910a	3	23
Jussin tuli häntä vähän surku.	250355	250385	lassila1910a	4	30
Jussin veri nousi loukkausta ajatellessa.	225973	226014	lassila1910a	4	41
Juttelee miesten kanssa heinäntulosta.	376091	376129	lehtonen1910a	3	38
Juutaksen hyvä tuuli katkesi.	621749	621778	lehtonen1910a	3	29
Juutaksen oli pakko antaa veneen seisahtua.	795030	795073	lehtonen1910a	5	43
Juutas ähkäisee.	489370	489386	lehtonen1910a	1	16
Juutas ällistyy.	477694	477710	lehtonen1910a	1	16
Juutas asettaa löylykipan oikealle puolelleen.	711476	711522	lehtonen1910a	4	46
Juutas ei laske pussiaan maahan.	373373	373405	lehtonen1910a	4	32
Juutas ei näytä kiiruhtavan niityltä.	635194	635231	lehtonen1910a	4	37
Juutas ei vastannut heti.	352152	352177	lehtonen1910a	3	25
Juutas etsii sitä säkki selässä.	382403	382435	lehtonen1910a	4	32
Juutas hoi.	156212	156223	lehtonen1910a	1	11
Juutas jättää kalan portaille.	200597	200627	lehtonen1910a	3	30
Juutas juoksee tupaa kohti.	497708	497735	lehtonen1910a	3	27
Juutas käänneksii sinne ja tänne.	494410	494443	lehtonen1910a	4	33
Juutas kääntelee päätänsä oikealle ja vasemmalle.	484792	484841	lehtonen1910a	5	49
Juutas Käkriäinen ällistyy.	454080	454107	lehtonen1910a	2	27
Juutas Käkriäinen höristää korviaan.	140645	140681	lehtonen1910a	3	36
Juutas Käkriäinen höristi korviaan ja huudahti.	620359	620406	lehtonen1910a	5	47
Juutas Käkriäinen jatkaa lönkytystään.	398990	399028	lehtonen1910a	3	38
Juutas Käkriäinen lähtee kantamaan.	370847	370882	lehtonen1910a	3	35
Juutas Käkriäinen pyyhkii hikeään.	402162	402196	lehtonen1910a	3	34
Juutas Käkriäisessä heräsi uteliaisuus.	341863	341902	lehtonen1910a	3	39
Juutas katsoo häneen vaaleat silmät pyöreinä.	482476	482521	lehtonen1910a	5	45
Juutas katsoo Kypenäiseen suu auki.	492435	492470	lehtonen1910a	4	35
Juutas kävelee edeltä, piika perästä.	378199	378236	lehtonen1910a	4	37
Juutas menee tuvan toiselle nurkalle.	500302	500339	lehtonen1910a	4	37
Juutas menee.	207020	207033	lehtonen1910a	1	13
Juutas näkee sen.	505322	505339	lehtonen1910a	2	17
Juutas on silmänräpäyksen vaiti.	454627	454659	lehtonen1910a	3	32
Juutas on vaiti.	796292	796308	lehtonen1910a	2	16
Juutas ottaa kanaa kiinni, se rätkättää.	385316	385356	lehtonen1910a	5	40
Juutas painui säkkeineen rantaan.	756264	756297	lehtonen1910a	3	33
Juutas pelkää.	498674	498688	lehtonen1910a	1	14
Juutas tuli etsimään papereita tupakkoihinsa.	742568	742613	lehtonen1910a	4	45
Juutas-parka ähkii ja puuskuttelee.	103981	104016	lehtonen1910a	3	35
Juutasta sekä vimmastuttaa että kauhistaa.	486135	486177	lehtonen1910a	4	42
Juutasta suututtaa kovasti.	100074	100101	lehtonen1910a	2	27
Juutasta.	767319	767328	lehtonen1910a	0	9
Jymähtää, ja käy kohina.	701514	701538	lehtonen1910a	3	24
Jyrkkä rinne on ihan alla.	382748	382774	lehtonen1910a	4	26
Jyrkkä.	380903	380910	lehtonen1910a	0	7
Jyrkkää muutosta ei näkynyt eikä ollut.	72114	72153	jarnefelt1913a	5	39
Kaakossa päin hohtaa kellertävä kuu.	756553	756589	lehtonen1910a	4	36
Käännähtävälle Hurjalle hän ainoastaan heilauttaa kättänsä.	523899	523958	lehtonen1910a	5	59
Käännyin poispäin karistaakseni ajoissa kyyneleet pois.	290879	290934	jarnefelt1916a	5	55
Kädessä oli vielä kappale nuorta leivänsisustaa.	9539	9587	canth1886a	5	48
Kädet nyrkissä hän puristi ohauksiaan.	212579	212617	canth1886a	4	38
Kädet olivat ristissä otsalla.	74158	74188	canth1886a	3	30
Kädet olivat seljän takana.	8860	8887	canth1886a	3	27
Kädet vetävät valtavan selän painolla.	179161	179199	lehtonen1910a	4	38
Kädetkin isommat kuin koko mies.	450392	450424	lehtonen1910a	4	32
Kaduilla ajeltiin rumassa lumisohjussa.	56673	56712	jarnefelt1916a	3	39
Kah, hyvää iltaa, Topi.	540483	540506	lehtonen1910a	3	23
Kahdeksankymmentä penniä, eihän se riitä leipäänkään.	42863	42916	canth1886a	5	53
Kahdella heistä oli todellakin vähänlaisesti toiveita.	62969	63023	jarnefelt1913a	5	54
Kahdeltakin suunnalta.	761658	761680	lehtonen1910a	1	22
Kahvi höyrysi pöydällä.	29946	29969	lassila1910a	2	23
Kahvin juotua he menivät tupaan.	200591	200623	canth1886a	4	32
Kaiken näköisiä.	214265	214281	canth1886a	1	16
Kaikenlaista hän on oppinut muilta, vanhoilta.	113668	113714	lehtonen1910a	5	46
Kaikesta täytyy olla vastineena passailu.	63052	63093	lehtonen1910a	4	41
Kaikissa.	150306	150315	lehtonen1910a	0	9
Kaikistako piironginavaimista kannattaisi asioitansa keskeyttää?	1960	2024	jarnefelt1916a	4	64
Kaikki halusivat nähdä yritystä.	15755	15787	pakkala1895a	3	32
Kaikki hämmästyivät.	84353	84373	pakkala1895a	1	20
Kaikki hänet tuntevat.	753248	753270	lehtonen1910a	2	22
Kaikki istuutuvat pöytään.	106757	106783	jarnefelt1913a	2	26
Kaikki iti hänen suuressa onnessansa.	171074	171111	jarnefelt1916a	4	37
Kaikki jättäytyi näin minun varaani.	39802	39838	jarnefelt1916a	4	36
Kaikki Käkriäiset ovat vielä kuopassa.	396600	396638	lehtonen1910a	4	38
Kaikki katsoivat heihin pitkään ja oudoksuen.	86938	86983	canth1886a	5	45
Kaikki kuuntelevat vaieten.	714904	714931	lehtonen1910a	2	27
Kaikki muut olivat hiljaa.	16234	16260	pakkala1895a	3	26
Kaikki muut paitsi Tepon Iikka.	75121	75152	pakkala1895a	4	31
Kaikki muutkin nauravat.	561169	561193	lehtonen1910a	2	24
Kaikki näyttivät terveiltä ja voimakkailta.	237014	237057	canth1886a	4	43
Kaikki oli järjestyksessä.	128098	128124	jarnefelt1916a	2	26
Kaikki olivat vain ystävällisesti hymyilleet.	27517	27562	pakkala1895a	4	45
Kaikki on ennallaan.	768117	768137	lehtonen1910a	2	20
Kaikki on hiljaista.	5999	6019	lehtonen1910a	2	20
Kaikki on minun syyni.	266195	266217	jarnefelt1916a	3	22
Kaikki ovat jännityksestä vaiti.	724572	724604	lehtonen1910a	3	32
Kaikki ovat vaiti.	674981	674999	lehtonen1910a	2	18
Kaikki ovat vaiti.	725143	725161	lehtonen1910a	2	18
Kaikki perustui puhtaaseen toveruuteen.	87823	87862	jarnefelt1916a	3	39
Kaikki riemastuivat.	99544	99564	pakkala1895a	1	20
Kaikki rupesivat kuuntelemaan.	98812	98842	pakkala1895a	2	30
Kaikki sitä tätä köyhää epäilevät.	84310	84344	lassila1910a	4	34
Kaikki tavarat oli ostettu.	100952	100979	lassila1910a	3	27
Kaikki turhaan.	427	442	canth1886a	1	15
Kaikki turhaan.	39326	39341	canth1886a	1	15
Kaikki uunhottama.	114860	114878	jarnefelt1913a	1	18
Kaikki vaikenivat ja kuuntelivat.	623610	623643	lehtonen1910a	3	33
Kaikki yhteensäkin?	511	530	pakkala1895a	1	19
Kaikki, mikä oli ollut hämärää, selveni.	41337	41377	pakkala1895a	5	40
Kaikki.	386731	386738	lehtonen1910a	0	7
Kaikki.	722672	722679	lehtonen1910a	0	7
Kaikkia ihmisiä he katsoivat, että huomaavatko.	23031	23078	pakkala1895a	5	47
Kaikkialla kiilsi ja välkkyi.	107112	107141	pakkala1895a	3	29
Kaikkien on tämä suru kestettävä.	139056	139089	jarnefelt1913a	4	33
Kaiku kalliosta vastaa.	642788	642811	lehtonen1910a	2	23
Kaisa alkoi nauraa kikattaa.	246046	246074	lassila1910a	3	28
Kaisa oli kuin kahden tulen välissä.	220818	220854	lassila1910a	5	36
Kaisa oli tuntenut samaa.	249888	249913	lassila1910a	3	25
Kaisa oli unohtanut yhden asian.	136814	136846	lassila1910a	4	32
Kaisa riemastui.	138485	138501	lassila1910a	1	16
Kaisa syötteli porsasta.	138954	138978	lassila1910a	2	24
Kaisa teki heille sormimerkkejä, minkä kerkesi.	237236	237283	lassila1910a	5	47
Kaisa vain ujosteli.	149271	149291	lassila1910a	2	20
Kaivataanpa elukkeiden parantajaa.	506770	506804	lehtonen1910a	2	34
Kaivonvintti vain ilmassa selkä valkoisena.	214221	214264	jarnefelt1916a	4	43
Kaivovesikin oli jo puhdistunut.	293597	293629	lassila1910a	3	32
Käkriäinen aikoo mennä veräjältä läävään.	391127	391168	lehtonen1910a	4	41
Käkriäinen ärjähtelee.	384835	384857	lehtonen1910a	1	22
Käkriäinen ei uhallakaan suostunut.	343905	343940	lehtonen1910a	3	35
Käkriäinen heittää löylyä melkein kipan loppuun.	716933	716981	lehtonen1910a	5	48
Käkriäinen ja Leja ovat niittämässä.	613754	613790	lehtonen1910a	4	36
Käkriäinen jää notkoon odottelemaan Ananiasta.	403315	403361	lehtonen1910a	4	46
Käkriäinen juoksee kanan kimppuun.	385240	385274	lehtonen1910a	3	34
Käkriäinen käännähtää ja lupaa sanoa.	721648	721685	lehtonen1910a	4	37
Käkriäinen katselee haarojaan.	364852	364882	lehtonen1910a	2	30
Käkriäinen katsoo.	507469	507487	lehtonen1910a	1	18
Käkriäinen kysyy muita kakaroita.	385681	385714	lehtonen1910a	3	33
Käkriäinen leikkii lastensa kanssa.	203813	203848	lehtonen1910a	3	35
Käkriäinen meni kuin menikin saunaan.	709065	709102	lehtonen1910a	4	37
Käkriäinen mietti tuokion.	623995	624021	lehtonen1910a	2	26
Käkriäinen myöntääkin tämän.	185715	185743	lehtonen1910a	2	28
Käkriäinen naurahtaa.	712332	712353	lehtonen1910a	1	21
Käkriäinen niittää.	635578	635597	lehtonen1910a	1	19
Käkriäinen nolostuu.	365087	365107	lehtonen1910a	1	20
Käkriäinen on astua sen päälle erehdyksessä.	205116	205160	lehtonen1910a	5	44
Käkriäinen on hiukkasen vaiti.	448335	448365	lehtonen1910a	3	30
Käkriäinen on hyvilläänkin.	376338	376365	lehtonen1910a	2	27
Käkriäinen örähtää jotakin.	527999	528026	lehtonen1910a	2	27
Käkriäinen otti hatunkin päästään.	351631	351665	lehtonen1910a	3	34
Käkriäinen pitelee silloin säkkiä kaksin käsin.	374715	374762	lehtonen1910a	5	47
Käkriäinen pujahti kohta takaisin kotaan.	709843	709884	lehtonen1910a	4	41
Käkriäinen pyrkii metsään pihan kautta.	499298	499337	lehtonen1910a	4	39
Käkriäinen seisoo ja kuulostelee.	527228	527261	lehtonen1910a	3	33
Käkriäinen suuttui vähäsen.	341269	341296	lehtonen1910a	2	27
Käkriäinen tahtoo tehdä työtä milloin haluaa.	409131	409176	lehtonen1910a	5	45
Käkriäinen tallustelee tuvan portaiden luo.	344166	344209	lehtonen1910a	4	43
Käkriäinen tuumii hetken.	368545	368570	lehtonen1910a	2	25
Käkriäinen väistyy vasemmalle, ruispellon pientareelle.	528195	528250	lehtonen1910a	4	55
Käkriäisen ääni örähtää taas.	156343	156372	lehtonen1910a	3	29
Käkriäisen korvat tillittävät.	401480	401510	lehtonen1910a	2	30
Käkriäisen mieli helpottuu.	561252	561279	lehtonen1910a	2	27
Käkriäisen nikamat naksahtelevat.	395276	395309	lehtonen1910a	2	33
Käkriäisen pitäisi saada jo puhua.	144794	144828	lehtonen1910a	4	34
Käkriäisen selkää alkaa hiottaa.	371719	371751	lehtonen1910a	3	32
Kaksi kiukaallista täällä on jo lämmitetty.	655617	655660	lehtonen1910a	5	43
Kaksi ovea oli porstuaan.	23968	23993	canth1886a	3	25
Kaksi?	184549	184555	canth1886a	0	6
Kalahtaa avaimen ensimäinen kierre.	123661	123696	jarnefelt1913a	3	35
Kalahtaa toinen.	123713	123729	jarnefelt1913a	1	16
Kalat pulahtelevat.	625551	625570	lehtonen1910a	1	19
Kalle tovereineen marjaan menossa.	101100	101134	pakkala1895a	3	34
Kallio pihan vieressä kaikuu.	641208	641237	lehtonen1910a	3	29
Kallion pykämällä Malakias ärsytteli pässiä.	78926	78970	lehtonen1910a	4	44
Kalliot räikkyvät.	788446	788464	lehtonen1910a	1	18
Kamarissa oma kirjahylly, oma pöytä.	107347	107383	pakkala1895a	4	36
Kamarissa tuntui mukavampi olla.	32310	32342	pakkala1895a	3	32
Kämpyräjalka.	101887	101900	lehtonen1910a	0	13
Kana eikä kukko.	18277	18293	lehtonen1910a	2	16
Kana istuu keskellä välikköä.	204985	205014	lehtonen1910a	3	29
Kana levittelee siipiään vihaisesti.	205161	205197	lehtonen1910a	3	36
Kanakin kuoli.	465017	465031	lehtonen1910a	1	14
Kangas huokuu ja hengittää.	112806	112833	lehtonen1910a	3	27
Kansa kuvittelee meitä kaikkia juopoiksi.	781892	781933	lehtonen1910a	4	41
Kantaa sinulle konttia sisään.	311139	311169	lehtonen1910a	3	30
Kanto on säkin puhkaissut.	383123	383149	lehtonen1910a	3	26
Kapsuttaa rannan kivikkoa, pienten leppien välitse.	152268	152319	lehtonen1910a	5	51
Kapteenikin oli käynyt tahtomassa vielä laivaansa.	42441	42491	pakkala1895a	5	50
Karjahtelemalla hän kiroilee.	383287	383316	lehtonen1910a	2	29
Karjakujalla alkavat lampaat määkiä.	689156	689192	lehtonen1910a	3	36
Karjapihalta kuuluu lasten ilakoimista.	456964	457003	lehtonen1910a	3	39
Karkottaisin pentuni?	786458	786479	lehtonen1910a	1	21
Karma.	140270	140276	jarnefelt1913a	0	6
Kärpäset hörisevät paksuna ja mustana parvena.	118051	118097	lehtonen1910a	5	46
Kärpäset kimahtelevat ja humisevat.	197934	197969	lehtonen1910a	3	35
Kärpäset kimisevät.	510929	510948	lehtonen1910a	1	19
Kartanolla alkoi nyt oikea säännöllinen saartaminen.	107635	107687	lassila1910a	5	52
Kartanolla oli luokki painumassa aitan seinässä.	23941	23989	lassila1910a	5	48
Karvain mielin aloin naruttaa kiinni liiviäni.	94425	94471	jarnefelt1916a	5	46
Kas noin.	98615	98624	canth1886a	1	9
Kas tuota pannua, kun jo kuohuu.	114802	114834	lassila1910a	5	32
Käski Hellun laittamaan tulta.	2215	2245	canth1886a	3	30
Käskipä neitiä siitä muka niiailemaan.	739321	739359	lehtonen1910a	4	38
Kasteesta, ja poudasta, ja ruosteesta.	213934	213972	lehtonen1910a	4	38
Kasvoissa vaihteli pelko ja pelastuksen toivo.	8813	8859	canth1886a	5	46
Kateudesta, ei mistään muusta.	197468	197498	canth1886a	3	30
Kätkyestä kuuluikin yhä surkeampia ohkauksia.	72136	72181	canth1886a	4	45
Katseemme ovat kohdanneet yhtämittaa toisensa.	3773	3819	jarnefelt1913a	4	46
Katselee heidän syömistään.	602654	602681	lehtonen1910a	2	27
Katseli huonetta, lamppua pöydällä ja huonekaluja.	194466	194516	canth1886a	5	50
Katselivat.	148119	148130	lehtonen1910a	0	11
Katso tuonne.	101399	101412	jarnefelt1916a	1	13
Katsohan, Lyygia, tuota humalistoa.	538869	538904	lehtonen1910a	3	35
Katsoi ympärilleen ja löysi Annin kapalovöitä.	79599	79645	canth1886a	5	46
Katsoin kuitenkin parhaaksi poistua.	194529	194565	jarnefelt1916a	3	36
Katsokaa itse.	156096	156110	jarnefelt1913a	1	14
Katsokaa minuun nyt ja hymyilkää pikkuisen.	196547	196590	canth1886a	5	43
Katsoo kelloaan.	106013	106029	jarnefelt1913a	1	16
Katsoo Paavaliin: Et ymmärrä?	140277	140306	jarnefelt1913a	3	29
Katsoo ympärilleen, tulee sisemmäs: Nukkuvatko molemmat.	155120	155176	jarnefelt1913a	5	56
Katsoppas kuinka sinä olet jo suuri.	139516	139552	jarnefelt1913a	5	36
Katsos, mamma, Tyysä.	130307	130328	canth1886a	2	21
Kättelee kumpaakin.	117517	117536	jarnefelt1913a	1	19
Katto harmaa.	229634	229647	lehtonen1910a	1	13
Kauan se jyrisee.	717039	717056	lehtonen1910a	2	17
Kauheasti hän seinään löi ja huusi.	89242	89277	canth1886a	5	35
Kaukaa jossakin laulavat kukot.	45080	45111	lehtonen1910a	3	31
Kauneinta on levätä, kauneinta tunteinansa levätä.	75462	75512	kilpi1903a	5	50
Kauniina oleminen on ihmisen hälvenemistä hetkeen.	42824	42874	kilpi1903a	5	50
Kauniit ovat silloin kalpeansiniset järvet.	5273	5316	lehtonen1910a	4	43
Kauniita kirjoja, joissa puhuttiin kansastakin.	769626	769673	lehtonen1910a	4	47
Kaunista on ja hiljaista.	627739	627764	lehtonen1910a	3	25
Kaunista täällä on.	533982	534001	lehtonen1910a	2	19
Kauppaneuvos hymyilee ystävällisin ja kirkkain silmin.	364985	365039	lehtonen1910a	5	54
Kauppaneuvos katselee häntä ja hymyilee.	376050	376090	lehtonen1910a	4	40
Kauppaneuvos kulkee edeltä.	373224	373251	lehtonen1910a	2	27
Kauppaneuvos tarjoaa paperossia.	374763	374795	lehtonen1910a	2	32
Kauppaneuvoskin hymähti.	360870	360894	lehtonen1910a	1	24
Kaupungissa ei häntä tarpeeksi tunneta puodeissa.	96747	96796	lehtonen1910a	5	49
Kaupunki on saarella.	283489	283510	lehtonen1910a	2	21
Kaupunkiin hän ei ole aikonut mennä.	110530	110566	lehtonen1910a	5	36
Kauvan istuivat kaikki ääneti.	197814	197844	lassila1910a	3	30
Kauvan mietittyään alkoi hän puhdistautua.	276408	276450	lassila1910a	4	42
Kauvan olivat ääneti.	63694	63715	lassila1910a	2	21
Kauvan olivat he ääneti.	225665	225689	lassila1910a	3	24
Kauvan surivat molemmat vaimot kahden kesken.	196138	196183	lassila1910a	5	45
Kävelee, kävelee.	111063	111080	lehtonen1910a	1	17
Käveli edestakaisin kannella, käveli pää kekassa.	244789	244838	lehtonen1910a	5	49
Kävellessäni takakylillä.	212671	212696	lehtonen1910a	1	25
Kehaista koreaa neitiä.	686928	686951	lehtonen1910a	2	23
Kehotettiin ja kehotettiin.	73504	73531	pakkala1895a	2	27
Kehtaat vielä itkeä.	162067	162087	canth1886a	2	20
Keikkuva kätkyt näkyy tuvan seinien alitse.	680045	680088	lehtonen1910a	5	43
Kello kävi kuudetta, oli aika lähteä.	203087	203124	canth1886a	5	37
Kello lyö: siitä Jopi sen huomasikin.	260574	260611	lehtonen1910a	5	37
Kello on kymmenen.	754472	754490	lehtonen1910a	2	18
Kello on yli puoli yksitoista.	758029	758059	lehtonen1910a	4	30
Kellojen helinää ja rominaa kuuluu.	676391	676426	lehtonen1910a	4	35
Kellot soivat.	218290	218304	canth1886a	1	14
Kenellä on hirsiä niistä, tekaisee.	289885	289920	lehtonen1910a	4	35
Kenellä vanha sauna, siitä kyhää.	289921	289954	lehtonen1910a	4	33
Kenelle sinä kirjoitit?	763773	763796	lehtonen1910a	2	23
Kenen kanssa olutta juomassa?	472747	472776	lehtonen1910a	3	29
Kengät olivat samanlaiset kuin tytöillä, korkearuojuiset.	110060	110117	pakkala1895a	5	57
Kenonen tunsi polviensa vapisevan.	281337	281371	lassila1910a	3	34
Kerput ovat nyt kuormavitsassa hänen selässään.	732082	732129	lehtonen1910a	5	47
Kerran hän otti minua kädestä.	160687	160717	jarnefelt1916a	4	30
Kerron sinulle sen unen.	142373	142397	jarnefelt1913a	3	24
Kerron teille, mitä olin hänestä kuullut.	11109	11150	jarnefelt1913a	5	41
Keskeltä lahtea näkyy autereinen järvi.	579948	579987	lehtonen1910a	4	39
Keskikaupungilla oli liikettä niin, että hämmästytti.	50366	50419	pakkala1895a	5	53
Kestävät joskus kokonaisen vuodenkin.	47568	47605	lehtonen1910a	3	37
Kestin vuosikausia.	18992	19011	jarnefelt1913a	1	19
Ketä sinä pelkäät, sano?	206855	206879	canth1886a	3	24
Kettusen poika lähti.	262523	262544	lassila1910a	2	21
Kielen murteellisuutta ei saa liioitella.	88133	88174	jarnefelt1913a	4	41
Kievarin mökissä hän oli asunut.	27900	27932	lehtonen1910a	4	32
Kiidettävä niinkuin palava taula hännän alla.	36151	36196	lehtonen1910a	5	45
Kiipeää rantakallioilta ylös metsään.	110314	110351	lehtonen1910a	3	37
Kiire nyt on.	555352	555365	lehtonen1910a	2	13
Kiireelliselle asialle oli Rosina hänet lähettänyt.	167974	168025	lehtonen1910a	5	51
Kilometrin päähän se ääni kaikuu.	413001	413034	lehtonen1910a	4	33
Kilpailijat tulivat taas näkyviin.	11916	11950	pakkala1895a	3	34
Kilvan juoksivat kivelle Ullan rientäessä edelleen.	88178	88229	pakkala1895a	5	51
Kipeästi koskee Juutaksen rintaan.	504049	504083	lehtonen1910a	3	34
Kirjakauppias kömpii moottorista rantakiville.	538611	538657	lehtonen1910a	3	46
Kirjeessä oli sekaisin suomea ja ruotsia.	140345	140386	jarnefelt1916a	5	41
Kirkas Athena.	23293	23307	kilpi1903a	1	14
Kirkkomme on Suomen vanhimpia.	79166	79196	jarnefelt1913a	3	30
Kissan kanssa aittaan sinut on pantava.	83743	83782	lehtonen1910a	5	39
Kissan se ennen tappoikin.	692379	692405	lehtonen1910a	3	26
Kiukku ja pelko kamppailevat Käkriäisen sielussa.	496761	496810	lehtonen1910a	5	49
Kiusata itseäänkin unettomuudella.	137092	137126	lehtonen1910a	2	34
Kivi on nostettu, jättiläisvoimilla, syliin mahtumaton.	395605	395660	lehtonen1910a	5	55
Kivijalka on jo valmis.	148949	148972	jarnefelt1916a	3	23
Kivijalkakin on vähäisen mustunut.	580725	580759	lehtonen1910a	3	34
Kodassa Ananias puikkaroi verkkoja.	650090	650125	lehtonen1910a	3	35
Kodassa riisuivat Mauno ja Ananias rytkiään.	708686	708730	lehtonen1910a	5	44
Kodasta kuuluu lasten juttelua.	651438	651469	lehtonen1910a	3	31
Koetan sanoa sinulle esimerkin.	279709	279740	jarnefelt1916a	3	31
Koetin heihin kaikkein viimeistä keinoani.	767990	768032	lehtonen1910a	4	42
Koetti hän sitten ennemmin pysyä valveilla.	37907	37950	canth1886a	5	43
Kohausin istualleni.	112330	112350	jarnefelt1913a	1	20
Kohauttaa olkaansa.	106030	106049	jarnefelt1913a	1	19
Kohentelee tulta.	670598	670615	lehtonen1910a	1	17
Kohottauduin nähdäkseni pihalle.	282169	282201	jarnefelt1916a	2	32
Kohta kohta jäät vapautuvat, helähti rinnassani.	57419	57467	jarnefelt1916a	5	48
Kohtisuoraan.	718763	718776	lehtonen1910a	0	13
Koivu mökin nurkalla näyttää melkein mustalta.	229533	229579	lehtonen1910a	5	46
Koivussahan se istuukin.	174891	174915	lehtonen1910a	2	24
Kokka kolahtaa rannan lohkareihin.	797649	797683	lehtonen1910a	3	34
Koko hänen kyyryinen yläruumiinsa vapisee.	313682	313724	lehtonen1910a	4	42
Koko huone täyttyy hetkeksi tanssijoista.	148355	148396	jarnefelt1913a	4	41
Koko mieli oli muualla.	126596	126619	canth1886a	3	23
Koko ruumis oli omituisesti väärässä.	55006	55043	pakkala1895a	4	37
Koko talo oli kuin autio.	43774	43799	pakkala1895a	4	25
Koko talo on kuin kuollut.	214518	214544	jarnefelt1916a	4	26
Kolkko hiljaisuus vallitsi huoneessa.	216860	216897	canth1886a	3	37
Kolkkona, kaameana kiviunena kaikki, aikakin hävinneenä?	96865	96921	kilpi1903a	5	56
Kolmas koputus ovelle.	148962	148984	jarnefelt1913a	2	22
Kolmisenkymmentä litraa hehdosta rukiita.	483770	483811	lehtonen1910a	3	41
Koloon?	276087	276094	lehtonen1910a	0	7
Kolotukseen taikka muuhun.	114665	114691	lehtonen1910a	2	26
Kölsiä lunastamaan taikka juottamaan pellistä.	188098	188144	lehtonen1910a	4	46
Komesrootti kiertelee tarjoilemassa miehille paperosseja.	373601	373658	lehtonen1910a	4	57
Kömpii itse aidan toiselle puolelle.	381839	381875	lehtonen1910a	4	36
Konetta on Malakias katsellut pitkät ajat.	574334	574376	lehtonen1910a	5	42
Kontrahti on yhtä helppo kuin ennenkin.	62592	62631	lehtonen1910a	5	39
Konttoriin perukkaan oli hänellä tärkeää asiaa.	594167	594214	lehtonen1910a	5	47
Koputus ovelle, kolmasti, harvaan.	148397	148431	jarnefelt1913a	3	34
Koreita kesiä ja hiljaisia talvia.	323022	323056	lehtonen1910a	4	34
Korjauttaisi itse tämän tuvan.	74883	74913	lehtonen1910a	3	30
Korkea koivu kasvaa mökin nurkalla.	8386	8421	lehtonen1910a	4	35
Korkean kukkulan harjalle he joutuvat.	610485	610523	lehtonen1910a	4	38
Korkeat petäjät seisoivat mykkinä pitkin rantoja.	204043	204092	canth1886a	5	49
Korpinrasvaako?	277419	277434	lehtonen1910a	0	15
Korsi katkeaa imureikään hänen vapisevissa käsissään.	494634	494687	lehtonen1910a	5	53
Korvissa humisi Villen kertomus.	193176	193208	lassila1910a	3	32
Korvosta kapustoi piimää palan painimeksi.	517807	517849	lehtonen1910a	4	42
Koska hän ei välitä kaaleista.	207706	207736	lehtonen1910a	4	30
Koski pääkuor-reen.	643404	643423	lehtonen1910a	1	19
Kosteutta on vielä alkukesän sateista maassa.	319573	319618	lehtonen1910a	5	45
Kotiopetus ei ollut suinkaan helppoa.	50267	50304	jarnefelt1916a	4	37
Kotona tuntui olevan niin hiljaista.	17708	17744	pakkala1895a	4	36
Kova se on maalaisen työ täällä.	781501	781533	lehtonen1910a	5	32
Kovaakin on maailmassa ollut.	321148	321177	lehtonen1910a	3	29
Kovanlainen tuuli pieksi Alman kasvoja.	236506	236545	canth1886a	4	39
Kovasti se huuto jo räikkyy.	420868	420896	lehtonen1910a	4	28
Kovempi on valkean Hurjan ääni mökiltä.	761681	761720	lehtonen1910a	5	39
Kovin reippaasti hän alkoi.	32534	32561	jarnefelt1916a	3	27
Köydet on heitetty suureen väkijoukkoon.	258379	258419	lehtonen1910a	4	40
Köyhä sisustus.	136760	136775	jarnefelt1913a	1	15
Köyhälle, muka.	49957	49972	lehtonen1910a	1	15
Köyhien ihmisten töllisköitä.	287561	287590	lehtonen1910a	2	29
Kuin kimppuun ampuen.	546043	546064	lehtonen1910a	2	21
Kuin lentämällä.	546026	546042	lehtonen1910a	1	16
Kuin tulen kipinät.	565695	565714	lehtonen1910a	2	19
Kuinka ensin muka pellit huoneessani vingahtivat.	9491	9540	jarnefelt1916a	5	49
Kuinka hän nyt sen neuvoisikaan?	718777	718809	lehtonen1910a	4	32
Kuinka hän sanoisi?	23758	23777	canth1886a	2	19
Kuinka lapsellista.	121599	121618	canth1886a	1	19
Kuinka ne ajat olivat muuttuneet siitä.	17289	17328	canth1886a	5	39
Kuinka niin?	104575	104587	jarnefelt1913a	1	12
Kuinka olen sellaiseksi tullut?	780585	780616	lehtonen1910a	3	31
Kuinka se asia oikeastaan onkaan?	115266	115299	jarnefelt1916a	4	33
Kuinka silloin saattoi kuitenkin olla erottamaton?	58921	58971	jarnefelt1916a	5	50
Kuinka tervehtivästi niiden räpinä kuuluu.	534200	534242	lehtonen1910a	4	42
Kuinkahan kauas se lentää?	60654	60680	pakkala1895a	3	26
Kuitenkin tuli Rosina levottomaksi Juutaksesta.	508329	508376	lehtonen1910a	4	47
Kuivailee suuria sankalasejaan.	547971	548002	lehtonen1910a	2	31
Kujan päässä on pieni lahti.	283374	283402	lehtonen1910a	4	28
Kuka haastelee paremmin kuin hän?	710335	710368	lehtonen1910a	4	33
Kuka ne sieltä varastaisi?	432053	432079	lehtonen1910a	3	26
Kuka oli siis syypäänä kauheaan tekoon?	44574	44613	jarnefelt1913a	5	39
Kuka on Jöijelle uimataidon opettanut?	87422	87460	jarnefelt1916a	4	38
Kuka se on?	98493	98504	jarnefelt1913a	2	11
Kuka sitä rohtoja potemaan?	569641	569668	lehtonen1910a	3	27
Kuka tässä on syynä niiden suuruuteen?	73889	73927	lehtonen1910a	5	38
Kuka tyydyttää rahvaan ahnastelua?	669523	669557	lehtonen1910a	3	34
Kukaan aikuisista ei hiisku sanaakaan.	1088	1126	jarnefelt1913a	4	38
Kukaan ei uskaltanut sille hisahtaa.	387616	387652	lehtonen1910a	4	36
Kukas se ilmaiseksi?	323823	323843	lehtonen1910a	2	20
Kukas sille ruuan tekee?	248548	248572	lehtonen1910a	3	24
Kulkea erilleen.	110636	110652	lehtonen1910a	1	16
Kuluu jonkin aikaa.	372143	372162	lehtonen1910a	2	19
Kummako se: eihän Muttinen kaikkea tiedä.	715582	715623	lehtonen1910a	5	41
Kummallinen hervottumus levittäytyy hänen mielensä ylle.	7353	7409	kilpi1903a	5	56
Kummastelee ainoastaan näiden elämää.	669744	669781	lehtonen1910a	3	37
Kummastellen tallustelee hän tuvan portaille.	157717	157762	lehtonen1910a	4	45
Kummatkin omissa eväissään.	168549	168576	lehtonen1910a	2	27
Kumpikaan ei puhunut toisellensa sanaakaan.	291940	291983	lassila1910a	4	43
Kun äidillä on lehmät lypsettävä.	676259	676292	lehtonen1910a	4	33
Kun ei vain pouta sitä polttelisi.	60235	60269	lehtonen1910a	5	34
Kun emme tiedä, niin emme tiedä.	140579	140611	jarnefelt1913a	5	32
Kun hän oli laskenut Saaran tervahöyryyn.	429378	429419	lehtonen1910a	5	41
Kun kerran tarjoaa, sitten suu kiinni.	737376	737414	lehtonen1910a	5	38
Kun kerran uhkaa.	619518	619535	lehtonen1910a	2	17
Kun komesrootti oli ollut niin pöyhkeä.	380335	380374	lehtonen1910a	5	39
Kun lehto sakenee, kulkee hän nopeammin.	609009	609049	lehtonen1910a	5	40
Kun Malakko ja Sanukka tappelivat.	565881	565915	lehtonen1910a	4	34
Kun niitä ei saa korjaamaan nurkkiaan.	658700	658738	lehtonen1910a	5	38
Kun saa kerran olla.	765453	765473	lehtonen1910a	3	20
Kun saisi asiaa vähänkin pohtia.	499086	499118	lehtonen1910a	4	32
Kun sulhanen silloin, ensimmäinen, jätti hänet.	321549	321596	lehtonen1910a	5	47
Kun syövät sellaisiakin kuin kärpässieniä, ruttopunaisia.	150374	150431	lehtonen1910a	5	57
Kun tarvitsevat niitä, sanoo äiti.	154122	154156	lehtonen1910a	4	34
Kun tunsin hetken lähestyvän, menin lehtoon.	112206	112250	jarnefelt1913a	5	44
Kun ukkonsa hänet jätti, Rosinukan.	522391	522426	lehtonen1910a	4	35
Kunhan ensin oikein köllöttelee, mötköttelee.	693957	694002	lehtonen1910a	4	45
Kunhan ette vaan sairastuisi tekin.	214609	214644	canth1886a	4	35
Kunhan on ruokaa.	99312	99329	canth1886a	2	17
Kunnes päämiehet ajoivat tytön lotjasta pois.	55521	55566	lehtonen1910a	5	45
Kunnioitus, se on ikävää.	780257	780282	lehtonen1910a	3	25
Kunpa tuo olisi edes ymmärtänyt auttaa.	68720	68759	jarnefelt1916a	5	39
Kuoleehan ihminen kuitenkin.	765838	765866	lehtonen1910a	2	28
Kuolema oli itsemurha.	123696	123718	jarnefelt1916a	2	22
Kuolema teki tuloaan.	216898	216919	canth1886a	2	21
Kuollut.	677568	677576	lehtonen1910a	0	8
Kuparossia?	280161	280172	lehtonen1910a	0	11
Kuppi tyhjenee kiireesti.	120491	120516	lehtonen1910a	2	25
Kurkistaa hänen tummiin silmiinsä.	648964	648998	lehtonen1910a	3	34
Kurkku, mikä lienee ollut.	151198	151224	lehtonen1910a	3	26
Kurppa huutaa kimeästi ja erämaisesti.	612343	612381	lehtonen1910a	4	38
Kuta alkeellisempia, sen tarkempia omastaan.	777397	777441	lehtonen1910a	4	44
Kuten herrojen ainakin.	783277	783300	lehtonen1910a	2	23
Kuu ui huimaavaa vauhtia räsäpilvien seassa.	99014	99058	jarnefelt1916a	5	44
Kuukauden?	184538	184548	canth1886a	0	10
Kuulehan nyt.	767867	767880	lehtonen1910a	1	13
Kuuletteko te, Topi ja Sanelma?	628692	628723	lehtonen1910a	4	31
Kuulitteko, hohoi?	628787	628805	lehtonen1910a	1	18
Kuulkaa.	21688	21696	jarnefelt1913a	0	8
Kuului puhetta ja astuntaa sisältä.	17947	17982	canth1886a	4	35
Kuulusteltiin kaikkia yhteisesti ja jokaista erikseen.	51285	51339	jarnefelt1913a	5	54
Kuulustelu alkoi.	235953	235970	lassila1910a	1	17
Kuuluu harvoin olevan, ei ennättävän, raiska.	248334	248379	lehtonen1910a	5	45
Kuuluu viikatteiden ja haravien suhinaa.	615387	615427	lehtonen1910a	4	40
Kuuntelee äärimmäisessä jännityksessä.	111619	111657	jarnefelt1913a	2	38
Kuuntelee muita.	304687	304703	lehtonen1910a	1	16
Kuus' on jo entiseltä.	87434	87456	canth1886a	3	22
Kykki päin aurinkoa.	335633	335653	lehtonen1910a	2	20
Kyl mine leksytte ylös hent.	99525	99553	jarnefelt1913a	4	28
Kylille lähtee mummo.	512328	512349	lehtonen1910a	2	21
Kylille vain, jonnekin.	110567	110590	lehtonen1910a	2	23
Kyllä ilmassa on tilaa.	693811	693834	lehtonen1910a	3	23
Kyllä olet merkillinen mies.	488731	488759	lehtonen1910a	3	28
Kyllä on kastetta maassa.	44176	44201	lehtonen1910a	3	25
Kyllä se Isäinen osaa ilmansa nostaa.	687480	687517	lehtonen1910a	5	37
Kyllä sinusta vävy tulee.	793966	793991	lehtonen1910a	3	25
Kyllä.	638018	638024	lehtonen1910a	0	6
Kylläinen Repekka se sitä teki.	442162	442193	lehtonen1910a	4	31
Kylläpä Saaran vaatteet ovat kurtussakin.	428364	428405	lehtonen1910a	4	41
Kylläpä vaadit mahdottomia.	164394	164421	jarnefelt1916a	2	27
Kylmemmiltä ne hänestä näyttivät ja synkemmiltä.	194676	194724	canth1886a	5	48
Kylvetään.	713367	713377	lehtonen1910a	0	10
Kymmeneen kappaleeseenko tässä olisi pitänyt revetä?	101245	101297	lehtonen1910a	5	52
Kymmenen suurta kuormaa oli valmiina.	271080	271117	lassila1910a	4	37
Kymmenkunta oli edellisiä, jälkimmäisiä pariinkymmeneen.	87832	87888	canth1886a	4	56
Kyntämäänkin on oppinut.	169769	169793	lehtonen1910a	2	24
Kypenäinen naurahtaa, että Juutas on hullu.	483567	483610	lehtonen1910a	5	43
Kypenäinen vaikenee hetkeksi.	488467	488496	lehtonen1910a	2	29
Kypsynevätkö ne?	356235	356251	lehtonen1910a	1	16
Kysyin kuinka oli käynyt.	83745	83770	jarnefelt1913a	3	25
Kysyin mitä virvoituskeinoja hän oli käyttänyt.	193342	193389	jarnefelt1916a	5	47
Kysymys herätti hämmästystä ja ihastusta poikajoukossa.	15505	15560	pakkala1895a	5	55
Kyykkysilleen täytyy taas kumartua.	656695	656730	lehtonen1910a	3	35
Kyynärpäitään viuhtoen hän tulee.	721971	722004	lehtonen1910a	3	33
Kyyneleet valuvat pientä nenää pitkin.	684032	684070	lehtonen1910a	4	38
Kyyryinen mummo.	22431	22447	lehtonen1910a	1	16
Laajalti kajahtelivat tyhjät kadut öisessä hiljaisuudessa.	61250	61308	jarnefelt1913a	5	58
Lääkäreitä joka jäsenelle.	6060	6086	jarnefelt1913a	2	26
Lääkäri alkoi nyt tehdä minulle kysymyksiä.	24513	24556	jarnefelt1913a	5	43
Lääkäri ja John tulivat sisään.	210172	210203	canth1886a	4	31
Lääkäri silmäili pöytää ja ikkunankarmia.	79794	79835	canth1886a	4	41
Lääniin.	106484	106492	lehtonen1910a	0	8
Lääniin.	110591	110599	lehtonen1910a	0	8
Läävän välikköön menee nyt Rosina.	732130	732164	lehtonen1910a	4	34
Lahdelta paukahtaa pyssynlaukaus.	788412	788445	lehtonen1910a	2	33
Lähden maailmalle.	159573	159591	jarnefelt1913a	1	18
Lahden perukassa leijailee usvaa.	762944	762977	lehtonen1910a	3	33
Lahden perukassa on hiljaista.	283890	283920	lehtonen1910a	3	30
Lahden perukkaan näkyy vastainen mantereen ranta.	283512	283561	lehtonen1910a	5	49
Lahden suu kiiltää hopeisena.	608843	608872	lehtonen1910a	3	29
Lahden toinen puoli on jyrkkää louhikkoa.	579299	579340	lehtonen1910a	5	41
Lahden vesi tummenee iltaan.	728866	728894	lehtonen1910a	3	28
Lähdetään järvelle.	115617	115636	canth1886a	1	19
Lähimpänä rannalla sauna.	8905	8930	lehtonen1910a	2	25
Laiskanpuoleinen on Mauno.	63989	64015	lehtonen1910a	2	26
Laiva ajaa yhä muurien ohitse.	253478	253508	lehtonen1910a	4	30
Laiva tulee jo ihan edessä.	188333	188360	lehtonen1910a	4	27
Laivalla.	311010	311019	lehtonen1910a	0	9
Lakkikin oli päässä, unohtui.	147997	148026	lehtonen1910a	3	29
Läksin pappilaan.	79148	79165	jarnefelt1913a	1	17
Lammen toisella puolella mäki.	611770	611800	lehtonen1910a	3	30
Lampaatkin siellä.	420212	420230	lehtonen1910a	1	18
Lampi huuruaa moninverroin sakeammin kuin järvi.	12423	12471	lehtonen1910a	5	48
Lampi on painunut varjoon.	632252	632278	lehtonen1910a	3	26
Lampi on syvällä ja musta.	611904	611930	lehtonen1910a	4	26
Lamppu pimenee.	717134	717149	lehtonen1910a	1	15
Läpi vaunun tuulee huikeasti.	3367	3396	jarnefelt1913a	3	29
Lapin emäntä siunaili päätään heiluttaen.	71741	71782	pakkala1895a	4	41
Lapset itkevät.	131364	131379	lehtonen1910a	1	15
Lapset itkivät ja juonittelivat.	88204	88236	canth1886a	3	32
Lapset katsahtivat toisiinsa ja naurahtivat keskenään.	216341	216395	jarnefelt1916a	5	54
Lapset katselevat yhä Saaraa.	132766	132795	lehtonen1910a	3	29
Lapset koristivat sitten hautakuopan kuusen havuilla.	86139	86192	jarnefelt1913a	5	53
Lapset rähisivät.	25995	26012	lassila1910a	1	17
Lapset tuolla leikkivät.	229359	229383	lehtonen1910a	2	24
Lapsi on nukahtanut uudestaan aamun hiljaisuudessa.	18135	18186	lehtonen1910a	5	51
Lapsikin rääkyy jälleen tuvassa.	511961	511993	lehtonen1910a	3	32
Laputa Putkinotkosta pois.	494915	494941	lehtonen1910a	2	26
Laskee sormilla.	107088	107104	jarnefelt1913a	1	16
Laskeusi tosin lauteilta ja tuli kotaan.	570696	570736	lehtonen1910a	5	40
Laskeutuu aitan portailta.	370883	370909	lehtonen1910a	2	26
Laski sitten Tyysän maahan.	130541	130568	canth1886a	3	27
Läskistä ja voista.	142982	143001	lehtonen1910a	2	19
Laulaa auringonpaisteessa säkeen kerrallaan.	325872	325916	lehtonen1910a	3	44
Laulaa säkeen nyt, toisen tuokion päästä.	314965	315006	lehtonen1910a	5	41
Lavea, matala, kodikas huone.	136730	136759	jarnefelt1913a	3	29
Lehmät päässeet syömään kauraa.	347712	347743	lehtonen1910a	3	31
Lehmät ynisevät, toiset ammuvat.	677956	677988	lehtonen1910a	3	32
Lehteni lakastuvat, rungolleni hiipii ruoste ruskea.	43926	43978	jarnefelt1913a	5	52
Leikillään.	307958	307969	lehtonen1910a	0	11
Leikkiä se oli.	102248	102263	canth1886a	2	15
Leipä loppuu, hyvä isä siunaa.	110800	110830	canth1886a	4	30
Leipää ja silliä.	301133	301150	lehtonen1910a	2	17
Leja aikoi juuri ruveta sitä pesemään.	744092	744130	lehtonen1910a	5	38
Leja askaroi nyt tuvassa kahvia keittämässä.	69898	69942	lehtonen1910a	5	44
Leja kuuluu antavan hänelle kepin.	743208	743242	lehtonen1910a	4	34
Leja on lähtenyt niitylle.	516908	516934	lehtonen1910a	3	26
Leja tuntee Sanelman juonet.	226996	227024	lehtonen1910a	3	28
Lejan paita on likomärkä ja kuuma.	219350	219384	lehtonen1910a	5	34
Lennätti sinne nuo neidin kengät.	594215	594248	lehtonen1910a	4	33
Leontjev ja Tyyni Leander rientävät perälle.	115147	115191	jarnefelt1913a	5	44
Lepäilemään huvilassaan.	530611	530635	lehtonen1910a	1	24
Leppänen.	138797	138806	jarnefelt1916a	0	9
Leppien lehdet ja hämähäkinverkotkin söhivät silmiin.	378383	378436	lehtonen1910a	5	53
Leppien lehdet kiiltävät.	58485	58510	lehtonen1910a	2	25
Levollisesti hän katsoi tuleviin ja söi.	9498	9538	canth1886a	5	40
Levottomuus enentyi.	82974	82994	lassila1910a	1	20
Liekö lapsi herännyt eikä ota nukkuakseen.	63891	63933	jarnefelt1913a	5	42
Liekö mennyt ulos.	254760	254778	jarnefelt1916a	2	18
Lieneekö saanut yhden napin pannuksi umpeen.	75842	75886	lehtonen1910a	5	44
Lieneekö se jo mennyt niitylle?	204370	204401	lehtonen1910a	4	31
Lieneekö siinä lammessa pohjaa?	221592	221623	lehtonen1910a	3	31
Lieneekö sulhanen, vai muutenko tuttu vaan.	19079	19122	canth1886a	5	43
Lieneekö taas mennyt makaamaan?	73680	73711	lehtonen1910a	3	31
Lieneeköhän se yhä äkäinen Maunolle?	635232	635268	lehtonen1910a	4	36
Lienevätkö sellaisia ne kaupungin muurit?	129300	129341	lehtonen1910a	4	41
Lihakasta.	515542	515552	lehtonen1910a	0	10
Liirakon liuskaako?	280118	280137	lehtonen1910a	1	19
Liisa häpesi, painoi päänsä alas.	73302	73335	pakkala1895a	4	33
Liisa oli heti jäljessä.	69090	69114	pakkala1895a	3	24
Liisa oli hyvillään.	69833	69853	pakkala1895a	2	20
Liisa oli mielestään kuin turvan takana.	82495	82535	pakkala1895a	5	40
Liisa?	92432	92438	jarnefelt1913a	0	6
Liisalle: Laitetaan vintihuoneeseen.	95719	95755	jarnefelt1913a	2	36
Liisan äiti etsi piiskat.	71783	71808	pakkala1895a	3	25
Liisan oli paha olla, mielensä kuohui.	74305	74343	pakkala1895a	5	38
Liisteetkin oli siinä säretty.	290868	290898	lassila1910a	3	30
Linnunholkit ovat tarkasti kätkeytyneet niiden rehevyyteen.	585474	585533	lehtonen1910a	5	59
Linnustamaan lähtenyt?	197770	197792	lehtonen1910a	1	22
Lintu kohahti aivan hänen vierestään.	172869	172906	lehtonen1910a	4	37
Liperiin vetää Kenosta.	38439	38462	lassila1910a	2	23
Liperissä se on vasta, oikea Suomi.	38463	38498	lassila1910a	5	35
Lisäksi rupesi emäntäkin juonittelemaan.	199399	199439	lassila1910a	3	40
Livertää kuin kiuru taivaalla.	68506	68536	lehtonen1910a	3	30
Löi osaamatta, mutta seiväs rusahti poikki.	79677	79720	lehtonen1910a	5	43
Löisin käpälät vastakarhaan.	185168	185196	lehtonen1910a	2	28
Loisina olivat eläneet.	322950	322973	lehtonen1910a	2	23
Loistaa kuin lumikirppu.	536399	536423	lehtonen1910a	2	24
Lopuksi kuumia perunoita ja nuorta maitoa.	200231	200273	canth1886a	5	42
Lopuksi vesittää, sammuttaa tulen.	507581	507615	lehtonen1910a	3	34
Lopulta se kumminkin alkoi selvitä.	223832	223867	lassila1910a	4	35
Lopulta.	485371	485379	lehtonen1910a	0	8
Löyly tasoittuu.	702355	702371	lehtonen1910a	1	16
Lukija ratkaiskoon.	189113	189132	jarnefelt1916a	1	19
Lukitsee lamppu kädessä oven.	791083	791112	lehtonen1910a	3	29
Lumpeissa värisevät keltaiset heteet.	626697	626734	lehtonen1910a	3	37
Luoteinen taivas kuultaa yhä keltaisena.	761559	761599	lehtonen1910a	4	40
Lupittaja se on, ja lupittaa.	56432	56461	lehtonen1910a	4	29
Lutmitvuorelle romeneeraamaan.	270204	270234	lehtonen1910a	1	30
Luukas kääntelehtii ja nyhkii.	226216	226246	lehtonen1910a	3	30
Luulee naistenkin mieleen olevan.	300533	300566	lehtonen1910a	3	33
Luulin sinulla olleen jotain pätevämpää.	150865	150905	jarnefelt1913a	4	40
Luullakseni perustuu kuitenkin tällainen väite erehdykseen.	236993	237052	jarnefelt1916a	5	59
Luullakseni Te kuitenkin ymmärrätte Hjördiksen väärin.	203372	203426	jarnefelt1916a	5	54
Luupat?	117504	117511	jarnefelt1913a	0	7
Luut ihan ruskivat puristuksesta.	62104	62137	lassila1910a	3	33
Lyö uudestaan, säkenöivin silmin.	158394	158427	lehtonen1910a	3	33
Lyödä sitä pitää.	678670	678687	lehtonen1910a	2	17
Lyygia istuu aitan portailla.	684161	684190	lehtonen1910a	3	29
Lyygia katoaa.	597030	597044	lehtonen1910a	1	14
Lyygia lukee.	785085	785098	lehtonen1910a	1	13
Lyygia nauraa Muttiselle, sammuttaessaan paperilyhtyjä.	790901	790956	lehtonen1910a	4	55
Lyygia nauraa.	624756	624770	lehtonen1910a	1	14
Lyygia on pysähtynyt oven taakse.	724427	724460	lehtonen1910a	4	33
Lyygia pukeutuu nopeasti.	746573	746598	lehtonen1910a	2	25
Lyygia tulee myöskin pieneen saliin.	598187	598223	lehtonen1910a	4	36
Lyyli vakuutti.	22603	22618	pakkala1895a	1	15
Maa on paratiisi.	156451	156468	jarnefelt1916a	2	17
Maailma on muuttunut muotoaan.	282671	282701	jarnefelt1916a	3	30
Maalaisistani oli saapunut vain talonpoika itse.	32017	32065	jarnefelt1916a	5	48
Maanmittari haetaan.	787888	787908	lehtonen1910a	1	20
Määrätyllä kellonlyönnillä olin perillä.	11949	11989	jarnefelt1916a	3	40
Madonna?	226995	227003	jarnefelt1916a	0	8
Mahdotonta se oli.	192940	192958	canth1886a	2	18
Maija kulki allapäin.	17645	17666	pakkala1895a	2	21
Maija Liisa katsoa muljautti joskus kahvipannuun.	76609	76658	lassila1910a	5	49
Maija Liisa nouti vaatteet.	266906	266933	lassila1910a	3	27
Maijaliisan hengitys muuttui raskaaksi ja tasaiseksi.	231692	231745	canth1886a	5	53
Maineeltaankin mokoma: linnassa istunut.	542633	542673	lehtonen1910a	3	40
Mainio tulee heinäpäivä, poudaksi aamukaste.	44202	44246	lehtonen1910a	4	44
Maistamaan ööliä.	270141	270158	lehtonen1910a	1	17
Maistui pahalle, että puistatti.	33272	33304	pakkala1895a	3	32
Maitopullon on hän työntänyt Luukkaan suuhun.	224945	224990	lehtonen1910a	5	45
Makaa aina.	55875	55886	lehtonen1910a	1	11
Makasiinin eteen ryntäsivät kaikki.	50679	50714	pakkala1895a	3	35
Makeaa se on Aapelin sieraimissa.	649887	649920	lehtonen1910a	4	33
Malakiaksen kasvoja ei nurkasta erota.	672820	672858	lehtonen1910a	4	38
Malakiaksen madoille.	278023	278044	lehtonen1910a	1	21
Malakias aikoi mennä rengiksi lääniin.	654288	654326	lehtonen1910a	4	38
Malakias katselee matorohtojaan.	439530	439562	lehtonen1910a	2	32
Malakias katselee rahojaan hellästi.	652748	652784	lehtonen1910a	3	36
Malakias katseli sitä, nuottakodan viereen pysähtyneenä.	170998	171054	lehtonen1910a	5	56
Malakias kulkee erilleen, rannalle pukeutumaan.	726284	726331	lehtonen1910a	4	47
Malakias kuuluu valittavan vatsaansa.	651668	651705	lehtonen1910a	3	37
Malakias maistelee perunaa.	682412	682439	lehtonen1910a	2	27
Malakias näet kertoo.	676505	676526	lehtonen1910a	2	21
Malakias on harras metsänasukkaiden ajattelija.	172171	172218	lehtonen1910a	4	47
Malakias on ikkunan ääressä.	680333	680361	lehtonen1910a	3	28
Malakias on lähestynyt moottoria.	536425	536458	lehtonen1910a	3	33
Malakias on verkalleen riisuutunut.	699060	699095	lehtonen1910a	3	35
Malakias puhkii kivellä.	537656	537680	lehtonen1910a	2	24
Malakias seisoo nyt riihen nurkalla yhä.	80290	80330	lehtonen1910a	5	40
Malakias seisoo, hojottaa, puolihorroksissa.	229384	229428	lehtonen1910a	3	44
Malakias tahtoisi kurittaa Repekkaa.	442194	442230	lehtonen1910a	3	36
Malakias uskoo Lejan tarinoihin.	221895	221927	lehtonen1910a	3	32
Malakias, mitä sinä honotat siinä?	86227	86261	lehtonen1910a	4	34
Malakias, tuo toinen heinäntekoon lähtijä?	167862	167904	lehtonen1910a	4	42
Malakias: ei siitä akanottoon.	324329	324359	lehtonen1910a	3	30
Malakias?	155251	155260	lehtonen1910a	0	9
Malakias?	159767	159776	lehtonen1910a	0	9
Malakiasta ei näy.	152658	152676	lehtonen1910a	2	18
Maljanen antoi humalassa muiden pettää itseään.	186726	186773	lehtonen1910a	5	47
Mamma saa silmänsä pyöreiksi.	87342	87371	jarnefelt1916a	3	29
Mamma sanoo aina; millä me elämme?	151882	151916	jarnefelt1916a	5	34
Mari astui nyt kiiruusti kotiapäin.	29627	29662	canth1886a	4	35
Mari intti, ettei hän ole tehnyt.	51686	51719	pakkala1895a	5	33
Mari näytti rauhoittuvan.	56640	56665	canth1886a	2	25
Mari odotti vastausta.	38177	38199	pakkala1895a	2	22
Mari oli aivan masennuksissaan.	38074	38105	pakkala1895a	3	31
Mari painoi taas toisella kädellä päätään.	54647	54689	canth1886a	5	42
Mari se ei kumminkaan ollut.	96375	96403	canth1886a	4	28
Maria?	115294	115300	jarnefelt1913a	0	6
Marilla ei ollut siihen sanomista mitään.	29093	29134	pakkala1895a	5	41
Marin huulet menivät surulliseen hymyyn.	18561	18601	canth1886a	4	40
Marjoja sanoo vieneensä hoville, rahanpennejä saadakseen.	687109	687166	lehtonen1910a	5	57
Märkänevätkin pian.	150034	150053	lehtonen1910a	1	19
Martille oli tuo kysymykseni ilmeinen pettymys.	106374	106421	jarnefelt1916a	5	47
Martin kertomus liikutti minua syvästi.	223482	223521	jarnefelt1916a	4	39
Martti alkoi suudella hänen päätänsä.	194261	194298	jarnefelt1916a	4	37
Martti ei edes huomannut sanojani.	286988	287022	jarnefelt1916a	4	34
Martti ei naurahtanut niinkuin minä tein.	105904	105945	jarnefelt1916a	5	41
Martti ei sanonut siihen mitään.	72265	72297	jarnefelt1916a	4	32
Martti ei uskonut.	268922	268940	jarnefelt1916a	2	18
Martti käänsi kohta tottelevaisesti veneen maalle.	72981	73031	jarnefelt1916a	5	50
Martti mietti vähän aikaa silmät pyöreinä.	281465	281507	jarnefelt1916a	5	42
Martti myhäili.	246742	246757	jarnefelt1916a	1	15
Martti oli hyvän aikaa vaiti.	229895	229924	jarnefelt1916a	4	29
Martti oli juuri saapunut kotiin.	221650	221683	jarnefelt1916a	4	33
Martti piiluaa paraikaa tukkeja.	149998	150030	jarnefelt1916a	3	32
Martti rakastuu.	239661	239677	jarnefelt1916a	1	16
Martti seisoi hetken aikaa neuvottomana.	79371	79411	jarnefelt1916a	4	40
Martti suuteli yhä hänen hiuksiansa.	195138	195174	jarnefelt1916a	4	36
Marttini seisoo piirissä muiden laulajien mukana.	280872	280921	jarnefelt1916a	5	49
Matalammat ulkorakennukset olivat melkein ummessa.	213720	213770	jarnefelt1916a	4	50
Matalan vastarannan lepikko on tumma.	608753	608790	lehtonen1910a	4	37
Matelemassa.	546873	546885	lehtonen1910a	0	12
Matka vei huvilan lahden poikki.	794086	794118	lehtonen1910a	4	32
Matkii?	82601	82608	lehtonen1910a	0	7
Matorohtona?	713795	713807	lehtonen1910a	0	12
Matti pitää Kustavaa kuin mitä rouvaa.	245036	245074	lehtonen1910a	5	38
Mauno alkaa torkkua.	454789	454809	lehtonen1910a	2	20
Mauno ja Ananias kömpivät viileään onkaloon.	798580	798624	lehtonen1910a	5	44
Mauno ja Rosina menevätkin.	310600	310627	lehtonen1910a	3	27
Mauno katselee Käkriäistä.	635167	635193	lehtonen1910a	2	26
Mauno katsoo tuokion hänen menoaan.	490273	490308	lehtonen1910a	4	35
Mauno kömpi hieman nolona tupaan.	547038	547071	lehtonen1910a	4	33
Mauno melkein unohtuu.	529163	529185	lehtonen1910a	2	22
Mauno on antanut sitä Käkriäiselle myytäväksi.	64588	64634	lehtonen1910a	5	46
Mauno on jo mennyt pihalle.	754868	754895	lehtonen1910a	4	27
Mauno on perässä.	658418	658435	lehtonen1910a	2	17
Mauno on sytyttänyt ostopaperossin.	481088	481123	lehtonen1910a	3	35
Mauno ottaa sen.	688546	688562	lehtonen1910a	2	16
Mauno röyhtäisee, Sinikanteleen eukko kiittää kauniisti.	441767	441823	lehtonen1910a	5	56
Mauno työntää kätensä Käkriäisen kainaloon.	485608	485651	lehtonen1910a	4	43
Maunon pelosta ei enää yhtään.	635635	635665	lehtonen1910a	4	30
Maunon Pertan Sanelma istuu niin pystynenäisenä.	455506	455554	lehtonen1910a	5	48
Maunon Pertta alkoi laulaa heleällä äänellä.	623644	623688	lehtonen1910a	5	44
Maunon Pertta hoilottaa.	438588	438612	lehtonen1910a	2	24
Maunon Pertta ja Sanelma haravoivat.	613791	613827	lehtonen1910a	4	36
Maunon Pertta on ehkä kotona.	285631	285660	lehtonen1910a	4	29
Maunon Pertta on kadonnut tuvasta.	454754	454788	lehtonen1910a	4	34
Maunon Pertta tulee saunalle.	721941	721970	lehtonen1910a	3	29
Maunon Pertta tyrskähtää.	752436	752461	lehtonen1910a	2	25
Maunon puhelu loittonee melkein kuulumattomiin.	496333	496380	lehtonen1910a	4	47
Maunon Sanelma hihittää.	642328	642352	lehtonen1910a	2	24
Me istuimme kohta melkein pimeässä.	59966	60001	jarnefelt1916a	4	35
Me käpälämäkeen.	61397	61413	jarnefelt1913a	1	16
Me saatoimme vapaasti katsoa toisiamme silmiin.	224073	224120	jarnefelt1916a	5	47
Me teemme liiton.	158918	158935	canth1886a	2	17
Meidän pitäisi saada totia alas lehtimajaan.	101831	101875	canth1886a	5	44
Meidän täytyy heti lähteä Marttia tapaamaan.	98682	98726	jarnefelt1916a	5	44
Meidän venettäkin kuljettelevat kaikeksi päivää.	248805	248853	lehtonen1910a	4	48
Meillä ei ole oikeaa asuntoa.	307029	307058	lehtonen1910a	4	29
Meillä oli miehiä vieraina.	42023	42050	pakkala1895a	3	27
Meillä oli mökki alhaalla harjun rinteellä.	67602	67645	jarnefelt1913a	5	43
Meissä ei ole tarmoa eikä jäntevyyttä.	144656	144694	canth1886a	5	38
Melkein mihinkään pehmoiseen astumatta.	543969	544008	lehtonen1910a	3	39
Mene heti pois.	162088	162103	canth1886a	2	15
Menee eteiseen.	141554	141569	jarnefelt1913a	1	15
Menee hetki.	520732	520744	lehtonen1910a	1	12
Menee kyökkiin.	93248	93263	jarnefelt1913a	1	15
Menee kyökkiin.	118521	118536	jarnefelt1913a	1	15
Menee nuottakodalle asti.	726332	726357	lehtonen1910a	2	25
Menee saunaan.	711233	711247	lehtonen1910a	1	14
Menee tainnoksiin poliisin ja Vanhan-Liisan syliin.	113128	113179	jarnefelt1913a	5	51
Menee tuokio.	677197	677210	lehtonen1910a	1	13
Menee, tehtyään sotilaskäänteen.	100550	100582	jarnefelt1913a	2	32
Menestys seurasi häntä.	16359	16382	jarnefelt1913a	2	23
Menevät minne Luoja sallii.	324737	324764	lehtonen1910a	3	27
Menge hakeman kersanti.	98957	98980	jarnefelt1913a	2	23
Meni rantaveräjälle.	388383	388403	lehtonen1910a	1	20
Menimme yhdessä.	283827	283843	jarnefelt1916a	1	16
Menköön Saara.	569570	569584	lehtonen1910a	1	14
Menköön Topi, jos ei Sanukka varpaaltaan.	568403	568444	lehtonen1910a	5	41
Mennään Kotkaan.	302379	302395	lehtonen1910a	1	16
Mennään niemen ympäri.	604188	604210	lehtonen1910a	2	22
Mennäänkö pois tästä?	270119	270140	lehtonen1910a	2	21
Mennäänkö?	283744	283754	jarnefelt1916a	0	10
Merille lähtemisestä minä sentään kysyin Jöijeltä.	107190	107240	jarnefelt1916a	5	50
Merkitsin paikan neljällä paalulla.	86002	86037	jarnefelt1913a	3	35
Mesopotamialaisia, muka marjamatkoilla.	599124	599163	lehtonen1910a	2	39
Metsä lakkaa kaiuttamasta Hurjan haukuntaa.	412764	412807	lehtonen1910a	4	43
Metsä loistaa vaaleanpunaisena lammen takana.	644343	644388	lehtonen1910a	4	45
Metsä räikkyy ja ruskaa.	383817	383841	lehtonen1910a	3	24
Metsäkanako se oli?	172129	172148	lehtonen1910a	2	19
Metsässä ovat olleet lekkerit.	411597	411627	lehtonen1910a	3	30
Metsästys.	94202	94212	jarnefelt1913a	0	10
Metso ei ole hänestä millänsäkään.	175986	176020	lehtonen1910a	4	34
Mi-mikä se on Jopilla peli?	82573	82600	lehtonen1910a	4	27
Miehen atraimesta se ei karkaa.	691441	691472	lehtonen1910a	4	31
Miehen mielenkiinto on jaollista.	250403	250436	jarnefelt1916a	3	33
Miehet ja poika perästä.	106943	106967	lassila1910a	3	24
Miehet poistuvat.	90623	90640	jarnefelt1913a	1	17
Miehet saapuivat jo lähelle Hyvärisen tiehaaraa.	274461	274509	lassila1910a	5	48
Miehet vaikenivat.	141308	141326	lassila1910a	1	18
Mieleisiä nämä Käkriäiset ovat minulle.	786310	786349	lehtonen1910a	4	39
Mielenkarvaus sen vaikutti.	132496	132523	lassila1910a	2	27
Mieletön mettiäinen, mitä teet sinä?	41109	41145	jarnefelt1913a	4	36
Mieli oli kotia päin lähtiessä painunut.	17667	17707	pakkala1895a	5	40
Mieli teki kiertää koko talo.	275663	275692	lassila1910a	4	29
Mielikuvitus oli aivan irrallaan.	34344	34377	pakkala1895a	3	33
Mielisuosiolla hänet saa mihin tahansa.	503028	503067	lehtonen1910a	4	39
Mieluummin minä menen laivaan.	623252	623282	lehtonen1910a	3	30
Mies alkoi jo kertoa omia salaisuuksiansa.	51841	51883	lassila1910a	5	42
Mies kuivaili lakitta päin ohimoitaan.	13228	13266	jarnefelt1916a	4	38
Mies makasi seinän puolella ja kuorsnasi.	1369	1410	canth1886a	5	41
Mies nauraa ja myönnyttelee.	257737	257765	jarnefelt1916a	3	28
Mies oli kuollut.	322747	322764	lehtonen1910a	2	17
Mies tuli kivulloiseksi, työhön kykenemättömäksi.	296963	297012	lehtonen1910a	4	49
Mies, näettekö, rakastaa sporttia.	112157	112191	canth1886a	3	34
Mieskin oli hereillä taas.	2246	2272	canth1886a	3	26
Miettiviksi kävivät miehet.	129734	129761	lassila1910a	2	27
Mihin hän ne nyt panee?	33531	33554	pakkala1895a	4	23
Mihinkäpä sudet vanhoina joutuvat?	324166	324200	lehtonen1910a	3	34
Mihinkäs ne?	692918	692930	lehtonen1910a	1	12
Mihinkäs tässä muuten jouduttaisiin?	54204	54240	lehtonen1910a	3	36
Miina teki niin.	233715	233731	canth1886a	2	16
Miina toi hänelle kirjelapun.	194854	194883	canth1886a	3	29
Miina tuli pyytämään häntä sisään.	151948	151982	canth1886a	4	34
Miina tuli sisään.	212743	212761	canth1886a	2	18
Miitä tämä on?	108123	108137	jarnefelt1913a	2	14
Miitä tämä on?	108468	108482	jarnefelt1913a	2	14
Miitä, miitä?	115248	115261	jarnefelt1913a	1	13
Miitä?	108116	108122	jarnefelt1913a	0	6
Mikä Kallen perii?	85662	85680	pakkala1895a	2	18
Mikä noiden onnettomain osaksi tulisi elämässä?	12024	12071	canth1886a	5	47
Mikä on mielessäsi?	92439	92458	jarnefelt1913a	2	19
Mikä onkaan mielessäsi?	124272	124295	jarnefelt1913a	2	23
Mikä panikin Juutaksen Muttista panettelemaan.	501729	501775	lehtonen1910a	4	46
Mikä siinä on sellainen: Yyyy-yy?	82518	82551	lehtonen1910a	4	33
Mikä sinulle siellä riihellä tuli?	499827	499861	lehtonen1910a	4	34
Mikä sinun on?	115309	115323	jarnefelt1913a	2	14
Mikä tulisi heille eteen.	29933	29958	canth1886a	3	25
Mikä vihertävä läiskä tuolla peränurkassa?	658129	658171	lehtonen1910a	4	42
Mikään ei ollut auttanut.	17998	18023	jarnefelt1916a	3	25
Mikään ei voi olla minulle yllätys.	92679	92714	jarnefelt1913a	5	35
Mikähän sen olisi pudottanut?	68098	68127	lehtonen1910a	3	29
Mikäs sitä kesäistä madetta ottamaan.	192303	192340	lehtonen1910a	4	37
Miks'ei ihminen aina sointuna keinu?	20610	20646	kilpi1903a	4	36
Miksi ajaa rikkauksia?	765801	765823	lehtonen1910a	2	22
Miksi ei Ananiaskin sellainen olisi?	472671	472707	lehtonen1910a	4	36
Miksi ei hän tullut veneellä?	380621	380650	lehtonen1910a	4	29
Miksi ei Kalle ollutkaan eksynyt?	86612	86645	pakkala1895a	4	33
Miksi ei olisi jättänyt?	321597	321621	lehtonen1910a	3	24
Miksi ei saa olla kotona?	116385	116410	pakkala1895a	4	25
Miksi ei vienyt heti takaisin kaikkia?	33409	33447	pakkala1895a	5	38
Miksi eivät ihmiset elä keskenään rauhassa?	112597	112640	lehtonen1910a	5	43
Miksi hän ei ole lampea laskenut?	478139	478172	lehtonen1910a	5	33
Miksi häntä vainotaan, aina?	505611	505639	lehtonen1910a	3	28
Miksi ihminen ei voi vapautua kuolemankammosta?	72894	72941	jarnefelt1913a	5	47
Miksi Luoja ei salli?	464563	464584	lehtonen1910a	3	21
Miksi ne ajoivat?	55568	55585	lehtonen1910a	2	17
Miksi ne kuolivat?	773475	773493	lehtonen1910a	2	18
Miksi ottikin niin paljon?	33382	33408	pakkala1895a	3	26
Miksi ponnistaisi henkeänsä selkeäksi ja kirkkaaksi?	75555	75607	kilpi1903a	5	52
Miksi säihkyisi tahtovaksi toivovaksi rohkeudeksi?	75608	75658	kilpi1903a	4	50
Miksi sairastuu äiti juuri Martin poissaollessa?	218165	218213	jarnefelt1916a	5	48
Miksi se sinne kärkeen, yksinäiseen paikkaan?	509462	509507	lehtonen1910a	5	45
Miksi sen tein?	767974	767989	lehtonen1910a	2	15
Miksi sitä Ripattiakin pidetään täällä?	340713	340752	lehtonen1910a	4	39
Miksi vaihtelee ihmisen olo niin?	102084	102117	kilpi1903a	4	33
Miksi vaivautuisi tahtomaan ja toivomaan?	75513	75554	kilpi1903a	4	41
Miksikä ei Jumala Kallea rangaissut?	86646	86682	pakkala1895a	4	36
Miksikä tulikin sieltä?	77436	77459	pakkala1895a	2	23
Milläs neuvoilla Rosina on tullut kotiin?	413036	413077	lehtonen1910a	5	41
Milloin hihkaisten leukapielet taivasta kohti levällään.	84966	85022	lehtonen1910a	5	56
Milloin suu pyöreänä ja möräkällä äänellä.	84923	84965	lehtonen1910a	5	42
Milloinkahan hän parantuu?	122282	122308	pakkala1895a	2	26
Minä _rakastan_ ruotsin kieltä.	281552	281583	jarnefelt1916a	3	31
Minä aivan itkin salatuista haukotuksista.	8154	8196	jarnefelt1913a	4	42
Minä aloin lähteä.	100634	100652	jarnefelt1916a	2	18
Minä annan tälle pitäjälle pitkät ruikulit.	296372	296415	lehtonen1910a	5	43
Minä en heitä suvaitse.	211613	211636	lehtonen1910a	3	23
Minä en sano mitään, ellei kysytä.	92051	92085	jarnefelt1913a	5	34
Minä en sanonut mitään.	106039	106062	jarnefelt1916a	3	23
Minä en syö pirujakaan.	151174	151197	lehtonen1910a	3	23
Minä en tehnyt kumpaakaan.	66561	66587	jarnefelt1913a	3	26
Minä en tiedä mitä tyyli onkaan.	1423	1455	jarnefelt1916a	5	32
Minä en voi kovistella Juutasta enää.	778866	778903	lehtonen1910a	5	37
Minä ensi anna uunipulfer Maarille.	117751	117786	jarnefelt1913a	4	35
Minä hämmästyin.	55059	55075	jarnefelt1916a	1	16
Minä katselemistani katselin häntä.	193305	193340	jarnefelt1916a	3	35
Minä kerroin kaiken.	24557	24577	jarnefelt1913a	2	20
Minä kun usutan kaikki kimppuusi.	492906	492939	lehtonen1910a	4	33
Minä nyt en vaan semmoisia usko.	214282	214314	canth1886a	5	32
Minä nyt en vaatteissa koreile.	488931	488962	lehtonen1910a	4	31
Minä olen enemmän kuin onnellinen.	54291	54325	jarnefelt1916a	4	34
Minä olen Kypenäisen Mauno.	493040	493067	lehtonen1910a	3	27
Minä olen maannut niissä ennenkin.	311668	311702	lehtonen1910a	4	34
Minä olen sellainen mies.	494856	494881	lehtonen1910a	3	25
Minä olin hyvän aikaa taas äimistyksissäni.	246896	246939	jarnefelt1916a	5	43
Minä olin päivän sankari.	54395	54420	jarnefelt1913a	3	25
Minä poltan.	386827	386839	lehtonen1910a	1	12
Minä pukeuduin.	220654	220669	jarnefelt1916a	1	15
Minä pysähdyn.	129853	129867	jarnefelt1913a	1	14
Minä rukoilen sinua _itseni_ vuoksi.	168772	168808	jarnefelt1916a	4	36
Minä sain kirjeen lukeakseni.	123451	123480	jarnefelt1916a	3	29
Minä sanoin jo nähneeni asianomaiset tulkittavat.	16639	16688	jarnefelt1916a	5	49
Minä sanoin uskovani.	89800	89821	jarnefelt1916a	2	21
Minä sanoin, kenen luona olin kotiopettajattarena.	55280	55330	jarnefelt1916a	5	50
Minä selitin, että ei.	75897	75919	jarnefelt1913a	3	22
Minä tahdon olla täällä aina.	764011	764040	lehtonen1910a	4	29
Minä tapoin.	111408	111420	jarnefelt1913a	1	12
Minä tiedän, mistä saa.	270159	270182	lehtonen1910a	3	23
Minä tunnen teidät niin hyvin, rakkaani.	32722	32762	jarnefelt1916a	5	40
Minä tunnen teidät.	150295	150314	jarnefelt1913a	2	19
Minä tunnustan.	110106	110121	jarnefelt1913a	1	15
Minä vaikenin.	44457	44471	jarnefelt1916a	1	14
Minä, hupsu, ostin pilkallani.	151100	151130	lehtonen1910a	3	30
Minähän olen sivistynyt muka.	779843	779872	lehtonen1910a	3	29
Minäkö en ymmärrä?	450556	450574	lehtonen1910a	2	18
Mine anna henel hjuvä, hjuvä paikka.	117202	117238	jarnefelt1913a	5	36
Mine ei voi kauemmi.	119462	119482	jarnefelt1913a	3	20
Mine kiitte Maria.	110374	110392	jarnefelt1913a	2	18
Mine ootta, da.	117186	117201	jarnefelt1913a	2	15
Mine teytty anmälä ett brottmål.	114429	114461	jarnefelt1913a	4	32
Minjä paaljo matkustanut.	107062	107087	jarnefelt1913a	2	25
Minkä minä kuolleella teen, ajattelin.	66787	66825	jarnefelt1913a	4	38
Minkä vuoksi hänen pitää täällä olla?	116347	116384	pakkala1895a	5	37
Minkähänlaisia nuo muurit ovat?	128078	128109	lehtonen1910a	3	31
Minkäpä tekee Juutas?	99707	99728	lehtonen1910a	2	21
Minkäs hänelle nyt enää mahtoi?	508296	508327	lehtonen1910a	4	31
Minkätähden ei elättää anneta?	505824	505854	lehtonen1910a	3	30
Minkätähden pitää ihmisten olla sellaisia?	97722	97764	lehtonen1910a	4	42
Minne hän aikoo?	500914	500930	lehtonen1910a	2	16
Minne hän lähtisi, hypähdettyään jaloilleen?	472308	472352	lehtonen1910a	4	44
Minne Juutas menee?	110463	110482	lehtonen1910a	2	19
Minne lie nyt mennyt, raukka?	520564	520593	lehtonen1910a	4	29
Minne lienee päässyt.	396460	396481	lehtonen1910a	2	21
Minne Luoja sallii pirujen viedä.	324765	324798	lehtonen1910a	4	33
Minnekä hän lähtee?	106393	106412	lehtonen1910a	2	19
Minnekä Saara menee, mitä, Sanukka?	160581	160616	lehtonen1910a	4	35
Minnekähän se lienee mennyt?	197741	197769	lehtonen1910a	3	28
Minnekähän se menee?	60505	60525	pakkala1895a	2	20
Minnekäpä Ananias sitten menee?	230037	230068	lehtonen1910a	3	31
Minnekäs se nyt ennätti lentää?	204316	204347	lehtonen1910a	4	31
Minnekäs se?	155261	155273	lehtonen1910a	1	12
Minua suututtaa, että se otettiinkin tänne?	591630	591673	lehtonen1910a	5	43
Minua suututtaa.	233942	233958	lehtonen1910a	1	16
Minulla ei ole mitään edellytyksiä sellaiseen.	7327	7373	jarnefelt1916a	5	46
Minulla kun on muitakin hyyryläisiä.	80559	80595	canth1886a	4	36
Minulla on kaikki selvillä.	485380	485407	lehtonen1910a	3	27
Minulla on kolme sikaa.	203044	203067	lehtonen1910a	3	23
Minun elefanttini?	590324	590342	lehtonen1910a	1	18
Minun kultainen munani?	590343	590366	lehtonen1910a	2	23
Minun olisi pitänyt se arvata.	157221	157251	jarnefelt1916a	4	30
Minun pieni elefanttini?	578055	578079	lehtonen1910a	2	24
Minun pitää näet silloin myös hymyillä.	4011	4050	jarnefelt1913a	5	39
Minun täytyi luvata.	98954	98974	jarnefelt1916a	2	20
Minunkin pitää maailmassa elää.	494824	494855	lehtonen1910a	3	31
Minunkin sydämeni alkoi suorastaan ilosta hyppiä.	253276	253325	jarnefelt1916a	5	49
Minunko äitini?	156052	156067	jarnefelt1913a	1	15
Minusta ei ole siihen.	772090	772112	lehtonen1910a	3	22
Missä aaltoisi ihmisen sielu unohtuneimpana uneksuntana?	46962	47018	kilpi1903a	5	56
Missä Antón Antónovitsh?	105498	105522	jarnefelt1913a	2	24
Missä hän on?	730042	730055	lehtonen1910a	2	13
Missä lienee Juutas?	421708	421728	lehtonen1910a	2	20
Missä lienee ollut.	51201	51220	lehtonen1910a	2	19
Missä lieneekin ollut Hurja juoksemassa.	68734	68774	lehtonen1910a	4	40
Missä ne ovat kaikki?	420675	420696	lehtonen1910a	3	21
Missä on Ananiaksen selkäsaunaa paennut Topi?	165010	165055	lehtonen1910a	5	45
Missä on siis oikeudenmukaisuus?	220100	220132	jarnefelt1916a	3	32
Missä saisi ihminen ihanimpana raueta?	46923	46961	kilpi1903a	4	38
Missä se kaupunki nyt lienee?	260330	260359	lehtonen1910a	4	29
Missä se nyt taas kutvehtii?	73439	73467	lehtonen1910a	4	28
Missä se on Leja?	511824	511841	lehtonen1910a	3	17
Missä se on?	159777	159789	lehtonen1910a	2	12
Missä se perhanan akka on?	277448	277474	lehtonen1910a	4	26
Missä se Sanelma lienee?	471754	471778	lehtonen1910a	3	24
Missä sinä asut?	55262	55278	jarnefelt1916a	2	16
Missä sinä olet ollut?	217107	217129	lehtonen1910a	3	22
Missä?	255875	255881	lehtonen1910a	0	6
Missä?	473445	473451	lehtonen1910a	0	6
Missä?	4904	4910	jarnefelt1913a	0	6
Missähän se kaupunki sitten on?	253530	253561	lehtonen1910a	4	31
Missähän se nyt lienee?	595465	595488	lehtonen1910a	3	23
Missäs Jopi ja Topi ovat?	554573	554598	lehtonen1910a	4	25
Missäs se meidän Sanelma on?	570061	570089	lehtonen1910a	4	28
Mistä ja minkä vuoksi?	173341	173363	jarnefelt1916a	3	22
Mistä rangaistusta?	218423	218442	jarnefelt1916a	1	19
Mistä se siihen yhtäkkiä lensi?	434543	434574	lehtonen1910a	4	31
Mistä syystä tapoin?	65138	65158	jarnefelt1913a	2	20
Mistä syystä?	60683	60696	lehtonen1910a	1	13
Mistäpä olisi kansalle parempaa esimerkkiä?	781733	781776	lehtonen1910a	4	43
Mitä aikonee?	548666	548679	lehtonen1910a	1	13
Mitä haet sinä?	40927	40942	jarnefelt1913a	2	15
Mitä hänellä on Esterissä auttamista?	544764	544801	lehtonen1910a	4	37
Mitä he siitä arvelisivat?	33435	33461	canth1886a	3	26
Mitä ihmeitä hän noin tuimasti ajattelee?	288683	288724	jarnefelt1916a	5	41
Mitä ihmeitä tämä on?	257148	257169	jarnefelt1916a	3	21
Mitä ihmettä hän sillä lienee tarkoittanut?	161003	161046	jarnefelt1916a	5	43
Mitä isket silmääsi, Rosinukka?	311058	311089	lehtonen1910a	3	31
Mitä Jumala niillä tekee?	83638	83663	pakkala1895a	3	25
Mitä kummaa?	58045	58057	lehtonen1910a	1	12
Mitä lienee opettaja tarkoittanut?	719030	719064	lehtonen1910a	3	34
Mitä lienevät rohtoja.	518051	518073	lehtonen1910a	2	22
Mitä minä siis surin?	27509	27530	jarnefelt1913a	3	21
Mitä mukavia?	531466	531479	lehtonen1910a	1	13
Mitä ne ihmiset sellaisesta ihmettelevät?	321721	321762	lehtonen1910a	4	41
Mitä niitä siihen jättää?	87523	87548	pakkala1895a	3	25
Mitä nyt?	123262	123271	jarnefelt1913a	1	9
Mitä odotti maailma minulta?	29656	29684	jarnefelt1913a	3	28
Mitä oli hän tehnyt?	131340	131360	canth1886a	3	20
Mitä oli sisaren lahjat tämän suhteen?	472	510	pakkala1895a	5	38
Mitä on elämä?	13485	13499	kilpi1903a	2	14
Mitä on kauniina oleminen?	33962	33988	kilpi1903a	3	26
Mitä on siis kauniina oleminen?	35736	35767	kilpi1903a	4	31
Mitä ovat maailman makeudet?	766164	766192	lehtonen1910a	3	28
Mitä sanoin minä siis sinulle?	145235	145265	jarnefelt1913a	4	30
Mitä se Hurja haukkuu?	405285	405307	lehtonen1910a	3	22
Mitä se Juutas siellä pihalla?	388194	388224	lehtonen1910a	4	30
Mitä se nyt niistä tiedustelee?	275224	275255	lehtonen1910a	4	31
Mitä se Saara sanoi?	140710	140730	lehtonen1910a	3	20
Mitä se siellä tekee?	248380	248401	lehtonen1910a	3	21
Mitä se taas täällä?	778583	778603	lehtonen1910a	3	20
Mitä se tuollainen on?	311954	311976	lehtonen1910a	3	22
Mitä siihen sanotte?	7782	7802	jarnefelt1913a	2	20
Mitä siis Martti oikeastaan oli?	175384	175416	jarnefelt1916a	4	32
Mitä sinä kirjoitit?	763725	763745	lehtonen1910a	2	20
Mitä sinä sanoitkaan minulle?	158150	158179	jarnefelt1913a	3	29
Mitä suloutta on väkisin annetulla ystävyydellä?	776649	776697	lehtonen1910a	5	48
Mitä tämä on?	93044	93057	jarnefelt1916a	2	13
Mitä tämä on?	259189	259202	jarnefelt1916a	2	13
Mitä tämä on?	259203	259216	jarnefelt1916a	2	13
Mitä tekisi?	75430	75442	kilpi1903a	1	12
Mitä varten hän oli yrittänytkään.	25965	25999	canth1886a	4	34
Mitä varten?	170447	170459	canth1886a	1	12
Mitä ystävällisin vastaanotto.	216632	216662	jarnefelt1916a	2	30
Mitä, Sanukka?	459394	459408	lehtonen1910a	1	14
Mitään vaikutusta puheillani ei ollut.	205822	205860	jarnefelt1916a	4	38
Mitähän ne ovat tehneet sillä aikaa?	121933	121969	pakkala1895a	5	36
Mitähän ne sanovat?	550308	550327	lehtonen1910a	2	19
Mitähän ne taas siellä mekastavat?	341903	341937	lehtonen1910a	4	34
Mitähän ne vieraat ovat?	405736	405760	lehtonen1910a	3	24
Mitähän ne viirut ovat?	175339	175362	lehtonen1910a	3	23
Mitähän niissä olisi?	553185	553206	lehtonen1910a	2	21
Mitähän nyt tullee.	548680	548699	lehtonen1910a	2	19
Mitähän se tarkoitti?	375558	375579	lehtonen1910a	2	21
Mitähän tytöt sanovat, kun hän parantuu?	128777	128817	pakkala1895a	5	40
Mitäpä hänellä oli sanottavaa?	69786	69816	canth1886a	3	30
Mitäpä rahaa Saaralla olisi?	250295	250323	lehtonen1910a	3	28
Mitäs ne lapset siellä?	201714	201737	lehtonen1910a	3	23
Mitäs se Juutas sanoi tässä Moksista?	387654	387691	lehtonen1910a	5	37
Mitäs sinä siinä ratustelet?	199672	199700	lehtonen1910a	3	28
Mitäs tämä on?	553404	553418	lehtonen1910a	2	14
Mitäs, jos Muttinen kuolisi perunamyrkytykseen?	600696	600743	lehtonen1910a	4	47
Mitäs, Mauno, jospa me autetaan Rosinukkaa?	522347	522390	lehtonen1910a	5	43
Miten hän tullee siellä toimeen.	214125	214157	canth1886a	4	32
Miten hemmetissä saisin hänet sitä rakastamaan?	779045	779092	lehtonen1910a	5	47
Miten ruskea sinä olet, sinä ruskeasilmä.	552766	552807	lehtonen1910a	5	41
Miten se oli selitettävissä?	86914	86942	jarnefelt1916a	3	28
Mitenkä tässä on ennättänyt sitä keitellä?	101202	101244	lehtonen1910a	5	42
Mitkä ovat oikeastaan vaatimuksenne miehiin nähden?	228874	228925	jarnefelt1916a	5	51
Mitkä?	722358	722364	lehtonen1910a	0	6
Moisesta Jussi yltyi silmittömäksi.	70612	70647	lassila1910a	3	35
Mökeissä ja taloissa.	52037	52058	lehtonen1910a	2	21
Mökiltä ei muita teitä kuin vesi.	782211	782244	lehtonen1910a	5	33
Mökin pihalla ei vielä liiku ketään.	12837	12873	lehtonen1910a	5	36
Mökin pihalla näyttää seisovan pari miestä.	536265	536308	lehtonen1910a	5	43
Mökin pihalla on aivan hiljaista.	465667	465700	lehtonen1910a	4	33
Mökin pihalla on hiljaista.	10957	10984	lehtonen1910a	3	27
Mökin savupiipusta leijailee sauhua.	613006	613042	lehtonen1910a	3	36
Mökkiläiset kerääntyvät ympärille.	375012	375046	lehtonen1910a	2	34
Mökkiläisiä possakassa.	338861	338884	lehtonen1910a	1	23
Mokomat parjaajat.	198011	198029	canth1886a	1	18
Moksi ponnistelee vastaan, naukaisee ja raapii.	640585	640632	lehtonen1910a	5	47
Moksia Repekka nyt vanuttaisi.	71645	71675	lehtonen1910a	3	30
Molemmat miettivät yhä asiaa.	20282	20311	lassila1910a	3	29
Molemmat olivat äänettöminä.	120749	120777	canth1886a	2	28
Molemmat palvelijat painoivat häntä takaisin vuoteelle.	234783	234838	canth1886a	5	55
Molemmat puhuivat ikäänkuin itseksensä.	149135	149174	lassila1910a	3	39
Molemmat samassa.	727726	727743	lehtonen1910a	1	17
Molemmat taas emme voi matkustaa.	207495	207528	jarnefelt1916a	4	33
Molemmin puolin ovea riippui päällysvaatteita seinällä.	24146	24201	canth1886a	5	55
Monesti ei Rosina käykään kaupungissa.	190122	190160	lehtonen1910a	4	38
Monta kertaa sain hihallani kuivata kasvoja.	273360	273404	jarnefelt1916a	5	44
Moottori kääntyi toisen niemen ympäri.	533692	533730	lehtonen1910a	4	38
Morsiamista kuullessaan Malakias punastuu vihasta.	170593	170643	lehtonen1910a	4	50
Morsian sitten.	201234	201249	canth1886a	1	15
Muista ikkunoista ei se vielä paistakaan.	117821	117862	lehtonen1910a	5	41
Muista se.	217410	217420	lehtonen1910a	1	10
Muista.	100485	100492	jarnefelt1913a	0	7
Muistaa se vaadittaa työhön.	367937	367965	lehtonen1910a	3	28
Muistakin asioista se oli nälkyttänyt.	27334	27372	lehtonen1910a	4	38
Muistan Jöijeäni hänen viidenneltä ikävuodeltaan asti.	49357	49411	jarnefelt1916a	5	54
Muistan.	349800	349808	lehtonen1910a	0	8
Muistotkin täällä minua siihen kehottavat.	766637	766679	lehtonen1910a	4	42
Muitakin ehtoja oli vielä.	28510	28536	lehtonen1910a	3	26
Muka vieraisilla, miestään kuljettaen.	245543	245581	lehtonen1910a	3	38
Mukavuuteen tottuneen.	697119	697141	lehtonen1910a	1	22
Multaa turpa täyteen.	506539	506560	lehtonen1910a	2	21
Mummo kulkee lämpöistä kujaa edelleen.	319620	319658	lehtonen1910a	4	38
Mummo menee läheltä kurkistamaan.	201251	201284	lehtonen1910a	3	33
Mummo on tuonut risuja kahvipuiksi.	327946	327981	lehtonen1910a	4	35
Mummo selittää, että eikö liene saanut.	426050	426089	lehtonen1910a	5	39
Mummo siunailee veräjällä.	80661	80687	lehtonen1910a	2	26
Mummo siunailee.	437701	437717	lehtonen1910a	1	16
Mummo tähystelee vielä pihalle päin.	688185	688221	lehtonen1910a	4	36
Mummo tuutii Luukasta.	422642	422664	lehtonen1910a	2	22
Mummo voihkii tätä poloista elämää.	516799	516834	lehtonen1910a	4	35
Mummon sanat muuttuvatkin kiitolliseksi ihmettelyksi.	433971	434024	lehtonen1910a	4	53
Musiikki soi.	189146	189159	canth1886a	1	13
Musta pimeys ammotti heille vastaan.	89070	89106	canth1886a	4	36
Musta sametti korottaa teidän hiviönne hohdetta.	197219	197267	canth1886a	5	48
Mut asia tule oikköyden etten.	110153	110183	jarnefelt1913a	4	30
Mut ei yhtaikka, rakas pikku.	95472	95501	jarnefelt1913a	4	29
Mut miitä tämä on?	108449	108467	jarnefelt1913a	3	18
Muta ei se ole niin.	203664	203684	jarnefelt1916a	4	20
Mutisi niiden olevan suuria.	73860	73888	lehtonen1910a	3	28
Mutta Aappo ei välittänyt enää.	68663	68694	pakkala1895a	4	31
Mutta äärettömän hauskaa se vaan oli.	67233	67270	jarnefelt1916a	5	37
Mutta äiti ei herännyt.	32911	32934	canth1886a	3	23
Mutta äiti ei siihen suostunut.	72059	72090	pakkala1895a	4	31
Mutta äiti heitä torui.	7324	7347	canth1886a	3	23
Mutta ajatukset menivät väkistenkin aina siihen.	126737	126785	canth1886a	5	48
Mutta älähän nyt hätäile.	789018	789043	lehtonen1910a	3	25
Mutta alkaminen on aina niin vaikea.	503475	503511	lehtonen1910a	5	36
Mutta Alma vielä pidätti.	123250	123275	canth1886a	3	25
Mutta Almalle tuli toinen tuska.	223940	223972	canth1886a	4	32
Mutta Alman silmät olivat auki yhä.	231746	231781	canth1886a	5	35
Mutta Ananiakselle tarjoaa Muttinen paperossin.	555601	555648	lehtonen1910a	4	47
Mutta Ananiasta ei näy.	384776	384799	lehtonen1910a	3	23
Mutta Anna Liisa oli vielä epätietoinen.	258443	258483	lassila1910a	5	40
Mutta antaisimme sen heille mielellämme anteeksi.	787481	787530	lehtonen1910a	5	49
Mutta Antti koetti vielä onneansa.	22204	22238	lassila1910a	4	34
Mutta Antti kokoilikin vain voimiansa.	31757	31795	lassila1910a	4	38
Mutta Antti osottautuikin oikeaksi puhemieheksi.	128301	128349	lassila1910a	4	48
Mutta asia ei ollutkaan unohtunut.	9737	9771	lassila1910a	4	34
Mutta ei hän siitä välittänyt.	330596	330626	lehtonen1910a	4	30
Mutta ei hän unta saanut.	132968	132993	canth1886a	4	25
Mutta ei häntä kukaan katsokaan.	286978	287010	lehtonen1910a	4	32
Mutta ei ihan ikkunan alla paskimassa.	389733	389771	lehtonen1910a	5	38
Mutta ei kukaan ollut nauranut.	27485	27516	pakkala1895a	4	31
Mutta ei kuulu hiljaistakaan lehmien ammumista.	46116	46163	lehtonen1910a	5	47
Mutta ei se äiti Jopille valehtele.	130305	130340	lehtonen1910a	5	35
Mutta ei se sen virkeämmäksi tullut.	75805	75841	lehtonen1910a	5	36
Mutta ei siinä kaikki.	191277	191299	jarnefelt1916a	3	22
Mutta ei siinä kyllin.	150933	150955	jarnefelt1916a	3	22
Mutta ei sitä mies voi peräytyä.	503396	503428	lehtonen1910a	5	32
Mutta ei tuli syttynyt vielä.	78148	78177	lassila1910a	4	29
Mutta ei.	254881	254890	jarnefelt1916a	1	9
Mutta eihän hän kiireiltään aina joutanut.	54083	54125	pakkala1895a	5	42
Mutta eihän John sitä kuullut.	131501	131531	canth1886a	4	30
Mutta eihän Partanen voinut sitä tietää.	214832	214872	lassila1910a	5	40
Mutta eihän Rosina häntä tarkoittanut, vierasta.	518693	518741	lehtonen1910a	5	48
Mutta eihän se nyt enää.	749512	749536	lehtonen1910a	4	24
Mutta eihän siellä ollutkaan mitään.	674877	674913	lehtonen1910a	4	36
Mutta eihän tuota nyt ruostetta tarvitakaan.	568157	568201	lehtonen1910a	5	44
Mutta eikö hän aio saunaan?	733187	733214	lehtonen1910a	4	27
Mutta eikö saa olla minun hilloani?	107454	107489	jarnefelt1913a	5	35
Mutta eipä Mauno aikone olla millänsäkään.	547127	547169	lehtonen1910a	5	42
Mutta eipä nyt tule Moksi moksittamallakaan.	197696	197740	lehtonen1910a	5	44
Mutta eivät ne häntä sinne ottaneet.	654422	654458	lehtonen1910a	5	36
Mutta eivät päästä rahtilaiset asiaa käsistään.	283636	283683	lassila1910a	5	47
Mutta eivät tahtoneet asettua.	125280	125310	pakkala1895a	3	30
Mutta eivät vain tappurat leimahtaneet.	96304	96343	lassila1910a	4	39
Mutta eiväthän kanervat vielä kukkine?	583517	583555	lehtonen1910a	4	38
Mutta eivätkö olleetkin pojat ilkeitä?	69609	69647	pakkala1895a	4	38
Mutta elää täytyy.	589600	589618	lehtonen1910a	2	18
Mutta Elsa oli pahoillaan.	46659	46685	pakkala1895a	3	26
Mutta Elsa tahtoi jo pikemmin.	43129	43159	pakkala1895a	4	30
Mutta en vaan voi pudottaa jyviä.	275647	275680	jarnefelt1916a	5	33
Mutta ennen saivat vapaisuudessaan polttaa.	751303	751346	lehtonen1910a	4	43
Mutta entäs Pyy-Pekan rintatippoja?	280549	280584	lehtonen1910a	3	35
Mutta entäs se Muttinen?	306450	306474	lehtonen1910a	3	24
Mutta Esteriä auttelee Maunon Pertan Sanelma.	437223	437268	lehtonen1910a	5	45
Mutta ettei se suuttuisi.	74784	74809	lehtonen1910a	3	25
Mutta hän ei ennätä.	119968	119988	lehtonen1910a	3	20
Mutta hän ei erottanut.	126335	126358	pakkala1895a	3	23
Mutta hän ei noussut kohta.	286069	286096	jarnefelt1916a	4	27
Mutta hän ei ollut siitä millänsäkään.	136725	136763	canth1886a	5	38
Mutta hän ei suostunut.	506402	506425	lehtonen1910a	3	23
Mutta hän nieli kiukkunsa.	242080	242106	lassila1910a	3	26
Mutta hän oli myöskin kokonaan toinen.	55663	55701	jarnefelt1916a	5	38
Mutta hän oli vihassa isällekin.	81571	81603	pakkala1895a	4	32
Mutta hänestä ei mitään apua ollut.	79012	79047	canth1886a	5	35
Mutta häntä olisi tarvittu pian.	81463	81495	lassila1910a	4	32
Mutta harvoin Rosina itsekään kirkkoon joutaa.	105233	105279	lehtonen1910a	5	46
Mutta he ajattelevat näin tottumuksesta.	133974	134014	jarnefelt1913a	4	40
Mutta Hellu ymmärsi sen itsestään.	70173	70207	canth1886a	4	34
Mutta herra oli antanut namusia lapsille.	738322	738363	lehtonen1910a	5	41
Mutta hiljaa onkin nyt Pertta.	431173	431203	lehtonen1910a	4	30
Mutta horjuu kivikin.	395310	395331	lehtonen1910a	2	21
Mutta hyvä merkki sekin.	738413	738437	lehtonen1910a	3	24
Mutta hyvää sanoo neiti sen olevan.	601844	601879	lehtonen1910a	5	35
Mutta ihmeitä on kukan elo täynnä.	43250	43284	jarnefelt1913a	5	34
Mutta ilkeää se on, se riiteleminen.	413961	413997	lehtonen1910a	5	36
Mutta iloissaan hän oli.	16785	16809	pakkala1895a	3	24
Mutta irvistelkööt, perhanat.	375183	375212	lehtonen1910a	2	29
Mutta isä oli minun puolellani.	269174	269205	jarnefelt1916a	4	31
Mutta isä on hyvällä päällä.	198289	198317	lehtonen1910a	4	28
Mutta itse seisoi, ja katseli muka.	75426	75461	lehtonen1910a	5	35
Mutta itsellään hän niitä häpeili.	110830	110864	pakkala1895a	4	34
Mutta jamahtipas komesrootti kiinni omaan loukkuunsa.	451854	451907	lehtonen1910a	5	53
Mutta John häntä hillitsi.	144571	144597	canth1886a	3	26
Mutta Jöije ei tahtonut kuullakaan puolustuksiani.	276694	276744	jarnefelt1916a	5	50
Mutta Jöijelle ei tänään onnistunut mikään.	73918	73961	jarnefelt1916a	5	43
Mutta Jopia hävettää.	262324	262345	lehtonen1910a	2	21
Mutta juohtui siinä vielä Partanenkin mieleen.	250308	250354	lassila1910a	5	46
Mutta Jussi oli kuohuksissaan.	136638	136668	lassila1910a	3	30
Mutta Jussin kieli alkoi päästä siteistä.	51758	51799	lassila1910a	5	41
Mutta Jussista se estely tuntui ivailulta.	132453	132495	lassila1910a	5	42
Mutta juuri tässä Te erehdyttekin.	205178	205212	jarnefelt1916a	4	34
Mutta kah, toisetpa sillä onkin haluttavat.	57689	57732	lehtonen1910a	5	43
Mutta kaikki tämä oli Jaakosta kevyttä.	3987	4026	pakkala1895a	5	39
Mutta Käkriäinen soutaa levottomana ja huokaisee.	186085	186134	lehtonen1910a	5	49
Mutta Käkriäistä kaivataan sitten.	506735	506769	lehtonen1910a	3	34
Mutta kartanolla liikkui vielä palvelijoita.	109175	109219	pakkala1895a	4	44
Mutta käskyä ei kuulukaan.	131473	131499	jarnefelt1913a	3	26
Mutta kaunista on se karu paikkakunta.	4844	4882	lehtonen1910a	5	38
Mutta keltaisen.	260126	260142	lehtonen1910a	1	16
Mutta kenenkäs heille nyt lisää?	569537	569569	lehtonen1910a	4	32
Mutta Kenonen ei ollut ääneti.	56515	56545	lassila1910a	4	30
Mutta kohta saat rakennuksestamme valokuvan.	164221	164265	jarnefelt1916a	4	44
Mutta korkeimpana kaikuu Rosinan ääni.	644390	644428	lehtonen1910a	4	38
Mutta korvissa soittaa.	378482	378505	lehtonen1910a	2	23
Mutta kovimmin nauraa pikku Sanelma.	681859	681895	lehtonen1910a	4	36
Mutta köyhemmän pitäisi sellaisia passailla.	55091	55135	lehtonen1910a	4	44
Mutta kuinka voi ihminen auttaa toista?	772050	772089	lehtonen1910a	5	39
Mutta kuinkas kävi tänä iltana?	737784	737815	lehtonen1910a	4	31
Mutta kuinkas kävi?	50534	50553	lehtonen1910a	2	19
Mutta kuitenkin tahtoi hän tietää jotain.	741263	741304	lehtonen1910a	5	41
Mutta kun maistoin, niin seinään mättäsin.	151131	151173	lehtonen1910a	5	42
Mutta kun riihessä liikkui.	677648	677675	lehtonen1910a	3	27
Mutta kuuluupa tuo nytkin.	413190	413216	lehtonen1910a	3	26
Mutta kuuntelehan mitä hän sanoo.	114231	114264	jarnefelt1913a	4	33
Mutta kyllä minä löydän kavereita muualtakin.	488596	488641	lehtonen1910a	5	45
Mutta kyllä minä tiedän.	713160	713184	lehtonen1910a	3	24
Mutta kylläpä niitä maittaa ruoka.	110718	110752	canth1886a	4	34
Mutta kyyneleitä ei hänellä enää ollut.	238834	238873	canth1886a	5	39
Mutta laivaan menee.	256765	256785	lehtonen1910a	2	20
Mutta lapsen päähän me sitä.	275917	275945	lehtonen1910a	4	28
Mutta lapset saunassa eivät liikahdakaan.	676428	676469	lehtonen1910a	4	41
Mutta lasin voi peittää sisältä.	294000	294032	lehtonen1910a	4	32
Mutta leppyi siitä.	520086	520105	lehtonen1910a	2	19
Mutta lieneeköhän se tarkoitus?	134958	134989	jarnefelt1913a	3	31
Mutta Liisa ei päässyt liikkeelle.	73532	73566	pakkala1895a	4	34
Mutta maalaiselämä on niin ikävää.	137555	137589	lehtonen1910a	4	34
Mutta mäen alla ratkesivat hevoselta rahkeet.	387441	387486	lehtonen1910a	5	45
Mutta mahtavalta se kuului.	9270	9297	pakkala1895a	3	27
Mutta maitoa kaataa hän Muttiselle.	600767	600802	lehtonen1910a	4	35
Mutta Majefski taisi olla jokin juomapaikka.	54868	54912	jarnefelt1913a	5	44
Mutta Malakias vihastui ja lähtikin lääniin.	654048	654092	lehtonen1910a	5	44
Mutta Mari oli onneton.	34317	34340	canth1886a	3	23
Mutta Martti ei nauranut.	68955	68980	jarnefelt1916a	3	25
Mutta Martti katselee ja katselee.	290306	290340	jarnefelt1916a	4	34
Mutta Martti rakentaakin aika suurta taloa.	147537	147580	jarnefelt1916a	5	43
Mutta mene nyt sentään sänkyysi.	193768	193800	canth1886a	4	32
Mutta mieli kävi yhä alakuloisemmaksi.	82780	82818	jarnefelt1913a	4	38
Mutta mihinkähän ne talvella joutuvat?	658661	658699	lehtonen1910a	4	38
Mutta milloin?	109394	109408	lehtonen1910a	1	14
Mutta minä en avannut, en.	143899	143925	jarnefelt1913a	4	26
Mutta minä en ole varastanut.	301415	301444	lehtonen1910a	4	29
Mutta minä muutan tässä kohden kirjoitustapani.	179437	179484	jarnefelt1916a	5	47
Mutta minä olen _todella_ tasapainossa jälleen.	162940	162987	jarnefelt1916a	5	47
Mutta minkälaista on sillä välin tuvassa?	126379	126420	lehtonen1910a	5	41
Mutta missäs on Topi?	555099	555120	lehtonen1910a	3	21
Mutta missäs se on Juutas?	156185	156211	lehtonen1910a	4	26
Mutta mistä ihmeestä me taas puhelimmekaan?	281692	281735	jarnefelt1916a	5	43
Mutta mitä niitä kaikkia luettelemaan.	275185	275223	lehtonen1910a	4	38
Mutta mitä onpi elämä?	98562	98584	kilpi1903a	3	22
Mutta mitähän syntiä hän on tehnyt?	51826	51861	pakkala1895a	5	35
Mutta mitäs se Ananias, koulustako?	718244	718279	lehtonen1910a	4	35
Mutta mitäs tuo Leja muuta tekee?	512176	512209	lehtonen1910a	5	33
Mutta mummo on väsynyt, ruumiinkin vaivoista.	327413	327458	lehtonen1910a	5	45
Mutta Muttinen painaiksen saunaan.	656520	656554	lehtonen1910a	3	34
Mutta muureja ei näy enää missään.	260683	260717	lehtonen1910a	5	34
Mutta myöntyväinen tahtoo Juutas olla herralle.	719066	719113	lehtonen1910a	5	47
Mutta ne olivatkin minulle tarpeeksi.	238466	238503	jarnefelt1916a	4	37
Mutta niiden kellot soivat jo kaukana.	402916	402954	lehtonen1910a	5	38
Mutta niin hänestä tuntui.	127457	127483	pakkala1895a	3	26
Mutta niinhän ne ihmiset.	324711	324736	lehtonen1910a	3	25
Mutta nyt alkoi Kenonen järjestellä asiaa.	259039	259081	lassila1910a	5	42
Mutta nyt alkoivat rahtilaisetkin valmistua.	281550	281594	lassila1910a	4	44
Mutta nyt ei Rosina ole kotona.	199043	199074	lehtonen1910a	5	31
Mutta nyt hän oli muuttunut toiseksi.	105170	105207	pakkala1895a	5	37
Mutta nyt hän on yksinään.	112707	112733	lehtonen1910a	4	26
Mutta nyt jatkuivat vain illalliset ajatukset.	220439	220485	jarnefelt1916a	5	46
Mutta nyt luulin hänen sittenkin surevan.	289746	289787	jarnefelt1916a	5	41
Mutta nyt mankii Topi mäelle päin.	234801	234835	lehtonen1910a	5	34
Mutta nyt nukkuivat tyssitkin.	225924	225954	lehtonen1910a	3	30
Mutta nyt oli ottanut myrkkyä.	630993	631023	lehtonen1910a	4	30
Mutta nyt on edessä toinen luokka.	638444	638478	lehtonen1910a	5	34
Mutta nyt se oli jo selvitetty.	618436	618467	lehtonen1910a	5	31
Mutta nyt taas ärtyisellä päällä.	330760	330793	lehtonen1910a	4	33
Mutta nyt tahtookin Rosina pestä neidin.	744131	744171	lehtonen1910a	5	40
Mutta olisipa siellä vaalijoita Rosinan tulemattakin.	512016	512069	lehtonen1910a	5	53
Mutta olkoon, ajattelee Käkriäinen.	140732	140767	lehtonen1910a	3	35
Mutta on tuo ilkanäköistä.	623166	623192	lehtonen1910a	3	26
Mutta pääsyy oli jokin muu.	20159	20186	jarnefelt1913a	4	27
Mutta Partanen ei väistynyt.	224278	224306	lassila1910a	3	28
Mutta pian juoksee hän takaisin sisältä.	606872	606912	lehtonen1910a	5	40
Mutta piippu ei pala.	494503	494524	lehtonen1910a	3	21
Mutta pöhötykseen sitä.	275699	275722	lehtonen1910a	2	23
Mutta Rosina pitää tuollaisesta Juutaksesta.	324066	324110	lehtonen1910a	4	44
Mutta Rosinalleko se Hurja noin rähisisi.	407277	407318	lehtonen1910a	5	41
Mutta runsaasti on varsinkin korkeita putkia.	9875	9920	lehtonen1910a	5	45
Mutta rynnäkkö ei onnistunut nytkään.	110036	110073	lassila1910a	4	37
Mutta Saara ei ollut enää vastannut.	741042	741078	lehtonen1910a	5	36
Mutta Saara kuorsaa.	451116	451136	lehtonen1910a	2	20
Mutta Saara makaa sikeässä unessa.	20696	20730	lehtonen1910a	4	34
Mutta Saara syö vielä.	146563	146585	lehtonen1910a	3	22
Mutta Saarallahan ei ole kenkiä jalassa.	604571	604611	lehtonen1910a	5	40
Mutta saavathan he huomenna.	91291	91319	pakkala1895a	3	28
Mutta saikohan se Juutas jauhoja myllyltä.	426006	426048	lehtonen1910a	5	42
Mutta säkin se oli metsään jättänyt.	426090	426126	lehtonen1910a	5	36
Mutta sanokaa, mikä siitä pelastaisi?	158721	158758	canth1886a	4	37
Mutta saunassa minä en rupea asumaan.	311416	311453	lehtonen1910a	5	37
Mutta savutorven varjo pikimusta.	229648	229681	lehtonen1910a	3	33
Mutta se alkaminen on niin vaikeaa.	47491	47526	lehtonen1910a	5	35
Mutta se heitä selittämään.	214582	214609	lehtonen1910a	3	27
Mutta se juttu on lorua.	359467	359491	lehtonen1910a	4	24
Mutta se oli lapsen isä.	67066	67090	jarnefelt1913a	4	24
Mutta se oli mahdotonta.	77411	77435	pakkala1895a	3	24
Mutta se on toinen asia.	6549	6573	jarnefelt1913a	4	24
Mutta se toivo ei toteutunut.	94951	94980	canth1886a	4	29
Mutta se tulee jälleen kujalle näkyviin.	730952	730992	lehtonen1910a	5	40
Mutta selittäkää se nyt myöskin tuolle.	41470	41509	jarnefelt1916a	5	39
Mutta sellaista hän ei tee.	376530	376557	lehtonen1910a	4	27
Mutta sen äänen hän pian tukahdutti.	151192	151228	canth1886a	5	36
Mutta sianpuolukoita ne olivatkin, ne puolukat.	797456	797503	lehtonen1910a	5	47
Mutta siellä kuuli hän ihmeellisiä asioita.	57030	57073	lassila1910a	5	43
Mutta siellä on myöskin härkä.	610242	610272	lehtonen1910a	4	30
Mutta sieltäkään hän ei leipää löytänyt.	9041	9081	canth1886a	5	40
Mutta siihen oli taas puhe loppua.	292855	292889	lassila1910a	5	34
Mutta siihen saa luottaa.	311217	311242	lehtonen1910a	3	25
Mutta siinä ei kestä lämmin.	25587	25615	lehtonen1910a	4	28
Mutta siinä oli kiiltonapit.	110312	110340	pakkala1895a	3	28
Mutta siinäpähän vaan jaksaa elää yhtäkaikki.	34742	34787	canth1886a	5	45
Mutta siirtyivätkö _he_ vai siirtyikö vesi?	75436	75479	jarnefelt1916a	5	43
Mutta siitä ei mitään ilmoitettu.	237860	237893	canth1886a	4	33
Mutta siitä huolimatta alakuloisuus ei mennyt.	83240	83286	jarnefelt1913a	5	46
Mutta siitäkös Rosina kiivastuu.	500116	500148	lehtonen1910a	3	32
Mutta silloin pyöristyivät Maija Liisan silmät.	96671	96718	lassila1910a	5	47
Mutta silti hän ei hellitä.	376366	376393	lehtonen1910a	4	27
Mutta silti hörisevät jo kärpäset tuvassa.	117960	118002	lehtonen1910a	5	42
Mutta sinulla on tietysti eri huone.	55376	55412	jarnefelt1916a	5	36
Mutta sinussako olisi lyöjää.	423382	423411	lehtonen1910a	3	29
Mutta sitä ette tee.	82748	82768	canth1886a	3	20
Mutta sitä kohden hän tahtomattaankin kulkee.	136041	136086	jarnefelt1913a	5	45
Mutta sitähän ne taitaisivat odottaakin.	669445	669485	lehtonen1910a	4	40
Mutta sitten alkoi puhe vaieta.	249629	249660	lassila1910a	4	31
Mutta sitten livistää Sanelma yhtäkkiä tiehensä.	227410	227458	lehtonen1910a	5	48
Mutta tarkasti hän nyt seurasi jatkoa.	201183	201221	canth1886a	5	38
Mutta tarvitsisi se vanhakin.	323867	323896	lehtonen1910a	3	29
Mutta tätäpä ei löytynytkään.	59705	59734	lassila1910a	3	29
Mutta täytyy otella.	756711	756731	lehtonen1910a	2	20
Mutta toisen komennolla, Maunon.	489473	489505	lehtonen1910a	3	32
Mutta toisin nyt.	17443	17460	canth1886a	2	17
Mutta tuliko asia silloin helpommin ymmärrettäväksi?	173557	173609	jarnefelt1916a	5	52
Mutta tuo eukko.	778517	778533	lehtonen1910a	2	16
Mutta tupakka on mennyt piipusta maahan.	382614	382654	lehtonen1910a	5	40
Mutta tuvasta kuuluu toinen meteli.	679931	679966	lehtonen1910a	4	35
Mutta Ullan oli omituisen paha olo.	103641	103676	pakkala1895a	5	35
Mutta varoopa hän isin pikku poikaa.	386209	386245	lehtonen1910a	5	36
Mutta varsinkin pikku Repukalla, Sirkkuna visertelevällä.	315688	315745	lehtonen1910a	5	57
Mutta vastausta ei kuulu.	152765	152790	lehtonen1910a	3	25
Mutta vastausta ei tule.	484934	484958	lehtonen1910a	3	24
Mutta Vatanen oli nyt tuittupäällä.	40191	40226	lassila1910a	4	35
Mutta veneen laidat rytkähtävät jokaisella vetäisyllä.	179232	179286	lehtonen1910a	5	54
Mutta vielä puuttuu jotakin.	698103	698131	lehtonen1910a	3	28
Mutta voiko heitäkään syyttää?	46653	46683	jarnefelt1913a	3	30
Mutta voisi kai pirttiä lämmittää?	24973	25007	lehtonen1910a	4	34
Mutta yht'äkkiä hiljensi hän kulkunsa.	57969	58007	pakkala1895a	4	38
Mutta yhtä kaikki hän pelkäsi.	224411	224441	canth1886a	4	30
Mutta yöllä ei tahtonut tulla uni.	200879	200913	lassila1910a	5	34
Mutta: eteenpäin sen on elävän katsottava.	389207	389249	lehtonen1910a	5	42
Mutta?	52449	52455	pakkala1895a	0	6
Muttinen antaa koko pussin neidilleen.	553811	553849	lehtonen1910a	4	38
Muttinen arastelee hiukan härkää.	610341	610374	lehtonen1910a	3	33
Muttinen hätkähtää ja rypistää hiukan kulmiaan.	542674	542721	lehtonen1910a	5	47
Muttinen ihmettelee mielessään, ja muutkin.	715538	715581	lehtonen1910a	4	43
Muttinen innostuu opettamaan Ananiasta.	718596	718635	lehtonen1910a	3	39
Muttinen istuu nyt tuvan portailla.	746600	746635	lehtonen1910a	4	35
Muttinen ja neiti kulkevat pian rantaan.	573173	573213	lehtonen1910a	5	40
Muttinen käännähtää ja ihmettelee.	684641	684675	lehtonen1910a	3	34
Muttinen kohottaa hätkähtäen päätänsä.	788574	788612	lehtonen1910a	3	38
Muttinen kumartuu ja pitelee korviaan.	717150	717188	lehtonen1910a	4	38
Muttinen on tullut portaiden luokse.	543200	543236	lehtonen1910a	4	36
Muttinen sanoo haeskelleensa Malakiasta ja Jopia.	652470	652519	lehtonen1910a	5	49
Muttinen seisoo jo portailla, valmiina lähtemään.	572629	572678	lehtonen1910a	5	49
Muttinen, neiti ja Saara joutuvat rantaan.	574224	574266	lehtonen1910a	5	42
Muttinenkin alkaa kylpeä.	717633	717658	lehtonen1910a	2	25
Muttinenkin on vielä toistaiseksi lupsakkaa miestä.	562721	562772	lehtonen1910a	5	51
Muttisen Aapelin on tartuttava puoshakaan.	534379	534421	lehtonen1910a	4	42
Muu se on heidän pahenemiseensa syynä.	186471	186509	lehtonen1910a	5	38
Muuan teki vääryyttä, löi väärällä vuorolla.	75922	75966	pakkala1895a	5	44
Muussa tapauksessa närkästyivät.	70778	70810	jarnefelt1916a	2	32
Muussa tapauksessa uhkasi rangaista koko luokan.	51575	51623	jarnefelt1913a	5	48
Muut kalat lienevät päässeet menemään.	191892	191930	lehtonen1910a	4	38
Muut lapset pyörivät Topin perästä.	643458	643493	lehtonen1910a	4	35
Muut lapset telmävät namustouhuissaan.	561212	561250	lehtonen1910a	3	38
Muut naiset lähtivät tekemään kylpyvastoja.	738875	738918	lehtonen1910a	4	43
Muuta ei hän hetkeen sano.	454726	454752	lehtonen1910a	4	26
Muuta ei Malakias kerrokaan.	653555	653583	lehtonen1910a	3	28
Muuta minä aioinkin sinulle tässä jutella.	767125	767167	lehtonen1910a	5	42
Muuta tuli siihen lisäksi.	156415	156441	canth1886a	3	26
Muutamat pysähtyivät uteliaina.	86984	87015	canth1886a	2	31
Muutamien välissä on melkoinen rako.	262528	262564	lehtonen1910a	4	36
Muuten me ajetaan halikkoon.	188892	188920	lehtonen1910a	3	28
Muuten on neiti istunut peräsimessä.	530842	530878	lehtonen1910a	4	36
Muuttaa takin, tulevat ruokasaliin.	94420	94455	jarnefelt1913a	3	35
Mykkinä seisoivat ristit lyhyine kirjoituksineen.	237894	237943	canth1886a	4	49
Myöhemmällä vasta valitsee kukin omansa.	163288	163328	canth1886a	4	40
Myöskin Aapelin on pakko kuukistaa niskaansa.	699472	699517	lehtonen1910a	5	45
Myrskyää viikkoja.	782192	782210	lehtonen1910a	1	18
Myyväthän herrat itsekin.	64738	64763	lehtonen1910a	2	25
Näen ristikon läpi kolkan nukkuvata kaupunkia.	63771	63817	jarnefelt1913a	5	46
Näes, kuinka ottaa apteekkarikin talrikilleen.	110753	110799	canth1886a	4	46
Näetkös, tuolla puiston päässä tuon kioskin.	261554	261598	lehtonen1910a	5	44
Nähdä vaivaa?	765824	765837	lehtonen1910a	1	13
Näin alussa.	701616	701628	lehtonen1910a	1	12
Näin haastelee Saara osittain tuolle miehelle.	261184	261230	lehtonen1910a	5	46
Näin hänet eräässä tilaisuudessa hännystakki yllä.	150717	150767	jarnefelt1916a	5	50
Näin Jöije.	117084	117095	jarnefelt1916a	1	11
Näin kertovat vanhat.	267688	267709	lehtonen1910a	2	21
Näin kylmällä.	187812	187826	canth1886a	1	14
Näin päättyi Jöijen myöhempi kertomus.	96990	97028	jarnefelt1916a	4	38
Näin paljoa ei niitä ole vaivaistalolla.	74069	74109	lehtonen1910a	5	40
Näin vähän oli Suomen kansalla sanomista.	85458	85499	jarnefelt1913a	5	41
Näin vilahtaa mummon päässä.	316335	316363	lehtonen1910a	3	28
Nainen se on.	265704	265717	lehtonen1910a	2	13
Naisen ei ole.	250437	250451	jarnefelt1916a	2	14
Naisenkin nimiä on verannan seinässä.	589133	589170	lehtonen1910a	4	37
Naisten tahdosta se on tapahtunut.	148145	148179	canth1886a	4	34
Näitä ajatellen läksin huoneestani ihmisiä tavoittelemaan.	221590	221648	jarnefelt1916a	5	58
Näkee kummakseen ja haikeudekseen.	781070	781104	lehtonen1910a	3	34
Näki kaikki heidät erikseen.	128154	128182	pakkala1895a	3	28
Näki rannalla Jopin.	432602	432622	lehtonen1910a	2	20
Nälkäkin veisaa jälleen kurria Malakiaksen mahassa.	666187	666238	lehtonen1910a	5	51
Nämä ovat maksaneet satakymmentäviisi markkaa.	25047	25093	pakkala1895a	4	46
Nämä perustelut vain naurattivat Jöijeä.	101172	101212	jarnefelt1916a	4	40
Nämä pyysivät minua piiaksi.	623283	623311	lehtonen1910a	3	28
Nanna oli kuin irti päästetty.	128545	128575	pakkala1895a	4	30
Nanna oli niin kaunis.	117685	117707	pakkala1895a	3	22
Nanna tuli iloiseksi.	127332	127353	pakkala1895a	2	21
Nannasta tuntui hyvälle, kun sai nukkua.	129116	129156	pakkala1895a	5	40
Närkästyi, kun käskin tuomaan puita liiteristä.	591582	591629	lehtonen1910a	5	47
Narkissos, suloutunut Narkissos, olisiko sinuna?	73235	73283	kilpi1903a	4	48
Narkissosta katselee Antinous, Narkissosta marmorissa.	72884	72938	kilpi1903a	4	54
Narri olin, että niitä istuttelin.	773627	773661	lehtonen1910a	4	34
Naurahtaa vain, että olkootpa vaikka sammakonmädissä.	201586	201639	lehtonen1910a	5	53
Naurahtikin jo.	748089	748104	lehtonen1910a	1	15
Nauroi vain.	268941	268953	jarnefelt1916a	1	12
Näytäs, minä laitan sinulle päänaluista.	76736	76776	canth1886a	4	40
Näytti aivan kamalalta.	112083	112106	lassila1910a	2	23
Ne ei saanovat.	114844	114859	jarnefelt1913a	2	15
Ne eivät koskaan kyllästytä tyttölaumaa.	8790	8830	jarnefelt1913a	4	40
Ne eivät pyörähtele eivätkä kääntelehdi.	178927	178967	lehtonen1910a	4	40
Ne olisi herätettävä.	225955	225976	lehtonen1910a	2	21
Ne olivat hänestä korkeita lumikinoksia.	126018	126058	pakkala1895a	4	40
Ne olivat jotain uusia koivuja.	80718	80749	jarnefelt1916a	4	31
Ne olivat porsaineen.	336065	336086	lehtonen1910a	2	21
Ne olivat ruvenneet rahoja jakelemaan, varastettuja.	676766	676818	lehtonen1910a	5	52
Ne olivat sittenkin paremmat.	112643	112672	pakkala1895a	3	29
Ne olivat vakavat.	134340	134358	canth1886a	2	18
Ne ovat kuin jääkarhun käpälät.	369445	369476	lehtonen1910a	4	31
Ne ovat myrkyllisiä elukkeita.	211637	211667	lehtonen1910a	3	30
Ne ovat nyt äidin suuressa nyytissä.	432357	432393	lehtonen1910a	5	36
Ne ovat tehneet ihmeitä.	214944	214968	lehtonen1910a	3	24
Ne ovatkin Martin varsan kulkuset.	254891	254925	jarnefelt1916a	4	34
Ne pilvet haihtuvat taivaalta.	181124	181154	lehtonen1910a	3	30
Ne pistävät ja imevät.	118321	118343	lehtonen1910a	3	22
Ne rahat kuitenkin jo loppuvat.	52394	52425	lehtonen1910a	4	31
Ne renkaat tyyntyvät ja hälvenevät.	12690	12725	lehtonen1910a	4	35
Ne ruskeanahkaiset ja matalat kengät.	134358	134395	lehtonen1910a	4	37
Ne ryyppäsi.	753373	753385	lehtonen1910a	1	12
Ne sieraimet paistavat punertavina.	101646	101681	lehtonen1910a	3	35
Ne suhisevat ja soivat yhtenä säveleenä.	118344	118384	lehtonen1910a	5	40
Ne tuprahtavat sieltä täältä, kaikkialta.	118098	118139	lehtonen1910a	4	41
Ne ulottuvat monen saran ylitse.	12143	12175	lehtonen1910a	4	32
Ne verenpuhdistustipat jäivät ostamatta.	281447	281487	lehtonen1910a	3	40
Ne ympäröivät aterialla istuvien päitä.	118281	118320	lehtonen1910a	4	39
Neiti asettuu kermapullo kädessä perään.	575017	575057	lehtonen1910a	4	40
Neiti ihmettelee.	567523	567540	lehtonen1910a	1	17
Neiti kiitti lämpöisesti.	739217	739242	lehtonen1910a	2	25
Neiti kuuntelee, ihmettelee ja hymyilee mielessään.	696695	696746	lehtonen1910a	5	51
Neiti meni hälisten keittiön läpi sisään.	359650	359691	lehtonen1910a	5	41
Nekään eivät vaikuttaneet mitään.	126490	126523	canth1886a	3	33
Neljäkymmentä syvää kuoppaa.	587973	588001	lehtonen1910a	2	28
Neljäs asema lähdettyä.	3014	3037	jarnefelt1913a	2	23
Ni panimaju.	114763	114775	jarnefelt1913a	1	12
Niiden alla kasvaa hyvä nurmi.	181309	181339	lehtonen1910a	4	30
Niiden lisäksi oli joukko heinäkuormia.	271182	271221	lassila1910a	4	39
Niiden määiskelyn kuulee imettävä emälammas navetalla.	689193	689247	lehtonen1910a	5	54
Niiden pitää pullistua ulos nahkasta.	717516	717553	lehtonen1910a	4	37
Niiden pitää syödä ja rinkua.	203068	203097	lehtonen1910a	4	29
Niiden tuoksu täytti tuvan.	7242	7269	lassila1910a	3	27
Niiden tyynyjen keskelle Muttinen istuutuu.	600343	600386	lehtonen1910a	4	43
Niiden väliin vetää Käkriäinen veneen tiukasti.	797684	797731	lehtonen1910a	5	47
Niidenkin hiljainen läpätys vaikenee jo melkein.	469511	469559	lehtonen1910a	5	48
Niillä ansioilla ostettuja kelloja.	407824	407859	lehtonen1910a	3	35
Niillä oli hauska ja hyvä olla.	108520	108551	pakkala1895a	5	31
Niin aikuisetkin.	131601	131618	lehtonen1910a	1	17
Niin alkoivat parata vanhat arvet.	293562	293596	lassila1910a	4	34
Niin ei ole ollut aina asianlaita.	544043	544077	lehtonen1910a	5	34
Niin että päästään lähtemään.	159420	159449	lehtonen1910a	3	29
Niin haaveilee Käkriäinen.	390648	390674	lehtonen1910a	2	26
Niin hän aina sanoi.	78793	78813	pakkala1895a	3	20
Niin hän teki entisestä tottumuksesta.	333220	333258	lehtonen1910a	4	38
Niin hävytön se on.	281684	281703	lehtonen1910a	3	19
Niin he juttelevat.	309297	309316	lehtonen1910a	2	19
Niin he tekivätkin.	63360	63379	lassila1910a	2	19
Niin huusi Topi isälleen.	75739	75764	lehtonen1910a	3	25
Niin hyvästi vinttasi.	65226	65248	lehtonen1910a	2	22
Niin istuivat he ia odottivat molemmat.	83250	83289	lassila1910a	5	39
Niin jatkoivat he vähin erin.	230406	230435	lassila1910a	4	29
Niin juteltuaan eroavat isä ja poika.	217588	217625	lehtonen1910a	5	37
Niin katselee, jos on hameita näkyvillä.	300450	300490	lehtonen1910a	5	40
Niin kaunis lapsi.	218619	218637	canth1886a	2	18
Niin kova on se aihe.	501940	501961	lehtonen1910a	4	21
Niin kuluivat pitkät ajat.	348416	348442	lehtonen1910a	3	26
Niin kymmenisen minuuttia.	216430	216456	lehtonen1910a	2	26
Niin kysyy pikku Sanelma.	221624	221649	lehtonen1910a	3	25
Niin lupasi Juutas.	75173	75192	lehtonen1910a	2	19
Niin luulisi.	133218	133231	jarnefelt1913a	1	13
Niin me arkipäiväiset ihmiset ainakin ajattelemme.	118314	118364	jarnefelt1916a	5	50
Niin menee hetki.	762979	762996	lehtonen1910a	2	17
Niin menee kymmenen minuuttia.	379239	379269	lehtonen1910a	3	30
Niin menee pari minuuttia.	609138	609164	lehtonen1910a	3	26
Niin menee pieniä hetkiä.	730770	730795	lehtonen1910a	3	25
Niin minä  ainakin luulen.	119910	119936	jarnefelt1913a	4	26
Niin mitenkäkö se sitten oli?	750914	750943	lehtonen1910a	4	29
Niin ne vihelsivät kuin pyypillit.	213176	213210	lehtonen1910a	4	34
Niin oli herra rähissyt.	622454	622478	lehtonen1910a	3	24
Niin olivat isäntämiehet sitä keitelleet, mokomaa.	751347	751397	lehtonen1910a	5	50
Niin oltiinkin.	91056	91071	pakkala1895a	1	15
Niin on hiljaista.	318742	318760	lehtonen1910a	2	18
Niin on ladon seinämällä päätetty.	616997	617031	lehtonen1910a	4	34
Niin on muka äiti käskenyt.	535209	535236	lehtonen1910a	4	27
Niin on yhä nukuttanut.	94050	94073	lehtonen1910a	3	23
Niin ovat ruvenneet sanomaan.	785677	785706	lehtonen1910a	3	29
Niin päästään vetämään heiniä.	518344	518374	lehtonen1910a	3	30
Niin pistää sisulleni.	491487	491509	lehtonen1910a	2	22
Niin pitäisi.	74387	74400	jarnefelt1913a	1	13
Niin saisi Jopikin kahvia.	435982	436008	lehtonen1910a	3	26
Niin sanoi Mauno varmasti luvaten.	618605	618639	lehtonen1910a	4	34
Niin sanoo Leukko ja tahtoo.	168428	168456	lehtonen1910a	4	28
Niin se ajoi, lupitti.	52014	52036	lehtonen1910a	3	22
Niin se asia on mennyt.	321341	321364	lehtonen1910a	4	23
Niin se on.	185156	185167	lehtonen1910a	2	11
Niin sen henki haisi vielä laivassa.	430904	430940	lehtonen1910a	5	36
Niin tahdon muistaa Putkinotkoa.	784448	784480	lehtonen1910a	3	32
Niin tapaus juoksi kuin vanhaa latuaan.	53374	53413	pakkala1895a	5	39
Niin tekee mieli.	102577	102594	lehtonen1910a	2	17
Niin teki Ullakin.	88649	88667	pakkala1895a	2	18
Niin tekivät viime kesänäkin.	38941	38970	lehtonen1910a	3	29
Niin tulee kitkaton löyly, herralle.	565463	565499	lehtonen1910a	4	36
Niin tuntui Jussin mielestä.	130895	130923	lassila1910a	3	28
Niin valahtuu ihminen kuin metsäksi ympärillä.	7984	8030	kilpi1903a	5	46
Niin, eivät koskaan, eivät koskaan.	5965	6000	jarnefelt1913a	4	35
Niin, ja sitten tynämenttiä.	564103	564131	lehtonen1910a	3	28
Niin, ketut pääsevät tupaan.	26435	26463	lehtonen1910a	3	28
Niin, kuuluu kirous, ja kauhea karjaisu.	76423	76463	lehtonen1910a	5	40
Niin, minulla on aavistus.	98513	98539	jarnefelt1913a	3	26
Niin, missä on Malakias, Käkriäisen esikoinen?	164937	164983	lehtonen1910a	5	46
Niin, niin ruokaa.	278443	278461	lehtonen1910a	2	18
Niin, niin: kuhilas pellolla, tuli tuvassa.	695304	695347	lehtonen1910a	5	43
Niin, Tolstoiko?	119782	119798	jarnefelt1913a	1	16
Niine hattuineen.	339533	339550	lehtonen1910a	1	17
Niinhän ne Ananiaksellekin olivat puhuneet koulussa.	359390	359442	lehtonen1910a	5	52
Niinhän se on vielä tänäpäivänä.	48093	48125	jarnefelt1913a	4	32
Niinkuin ääretön liikkumattomuus selkenee ihmisen tunteeksi.	54638	54698	kilpi1903a	5	60
Niinkuin ammuttuina.	311020	311040	lehtonen1910a	1	20
Niinkuin ennen takavuosina kissantappajaksi.	391656	391700	lehtonen1910a	3	44
Niinkuin karhu se mormottaa.	48815	48843	lehtonen1910a	3	28
Niinkuin karhu talvella.	47742	47766	lehtonen1910a	2	24
Niinkuin kaunista unta.	127821	127844	lehtonen1910a	2	23
Niinkuin keinuvasti liukuu tunnelmakseen.	42875	42916	kilpi1903a	3	41
Niinkuin liuenneena sulaa yllesi.	32849	32882	kilpi1903a	3	33
Niinkuin notkea, notkeneva taipumus kulkee jäseniänsä.	26559	26613	kilpi1903a	5	54
Niinkuin on vuosi vuodelta muuttunut ilkeämmäksi.	545961	546010	lehtonen1910a	5	49
Niinpä hän puolittain ratsastaa kätkyellä.	682591	682633	lehtonen1910a	4	42
Niinpä saattaakin Saara niitä lainata.	133148	133186	lehtonen1910a	4	38
Niissä heille oli lohdutusta.	222387	222416	canth1886a	3	29
Niissä paloi synkkä, uhkaava tuli.	77536	77570	canth1886a	4	34
Niistä säteilee ihanasti palava hohde.	521420	521458	lehtonen1910a	4	38
Niistähän se laituri syntyy.	538507	538535	lehtonen1910a	3	28
Niitä emme voi välttää.	83168	83191	canth1886a	3	23
Niitä menee hän huvikseen katselemaan.	232388	232426	lehtonen1910a	4	38
Niitä oikeita pelkkiä ihmisiä: aina lystikkäitä.	766975	767023	lehtonen1910a	5	48
Niitä on hilattava lisää.	628615	628640	lehtonen1910a	3	25
Niitä on niin paljon.	214610	214631	lehtonen1910a	3	21
Niitä on siellä monenlaisia.	287723	287751	lehtonen1910a	3	28
Niitä on suurempiakin, melkein lantun kokoisia.	196993	197040	lehtonen1910a	5	47
Niitä toi Rosina Potamiasta.	489992	490020	lehtonen1910a	3	28
Niityllä on hiljaista.	222559	222581	lehtonen1910a	2	22
Nimiä eivät olleet saaneet tietää.	62290	62324	jarnefelt1913a	4	34
Nimistä ei hänkään ollut saanut tietoa.	62524	62563	jarnefelt1913a	5	39
Nipistää housunsauman kohdalta ja ravistaa lahkeesta.	146910	146963	lehtonen1910a	5	53
Njiin?	115689	115695	jarnefelt1913a	0	6
Njut kaaikki hjuvä.	117092	117111	jarnefelt1913a	2	19
No eihän se.	278462	278474	lehtonen1910a	2	12
No hyve-e-e-e ilta-a-a-a.	94029	94054	jarnefelt1913a	2	25
No ja kaivakaa.	5250	5265	jarnefelt1913a	2	15
No niin.	775318	775326	lehtonen1910a	1	8
No niin.	12979	12987	jarnefelt1913a	1	8
No on sitä Ihalainen kerrakseen.	295955	295987	lassila1910a	4	32
No oteltiin siinä.	61703	61721	lassila1910a	2	18
No sanokaa, sanokaa.	42214	42234	jarnefelt1916a	2	20
No, ehkäpä sinä puhut jullilleen?	666724	666757	lehtonen1910a	4	33
No, heitä ei kuumuus kammota.	23263	23292	lehtonen1910a	4	29
No, kas nyt taas.	117560	117577	canth1886a	3	17
No, kuka siellä taas tulee?	98667	98694	canth1886a	4	27
No, Kuula, mite teme ny on?	99598	99625	jarnefelt1913a	5	27
No, maistahan, maista.	95380	95402	jarnefelt1913a	2	22
No, mite teme on?	94550	94567	jarnefelt1913a	3	17
No, nähdäänhän.	427188	427203	lehtonen1910a	1	15
No, onpas sinulla into reissuun.	155375	155407	lehtonen1910a	4	32
No, suoraan sanoen, en tiedä.	778470	778499	lehtonen1910a	4	29
Noiden lasten tähden.	74942	74963	lehtonen1910a	2	21
Noihin vaivaisiin kinttuihisi.	492940	492970	lehtonen1910a	2	30
Nolopa tässä nyt on Käkriäisen olla.	365227	365263	lehtonen1910a	5	36
Noo, ja siinäkö kaikki?	119933	119956	canth1886a	3	23
Nosti päänsä pystyyn ja suoristi, hartioitaan.	176622	176668	canth1886a	5	46
Nosti siinä toisen jalkansakin aidan rakoon.	388404	388448	lehtonen1910a	5	44
Nousee äkkiä istualtaan.	107738	107762	jarnefelt1913a	2	24
Nousee ylös ja heiluttelee käsivarsiaan.	504693	504733	lehtonen1910a	4	40
Nousin, kuljin huomaamatta heidän ohitsensa.	194567	194611	jarnefelt1916a	4	44
Nousipa nyt käsi korvalliselle.	149667	149698	lassila1910a	3	31
Nouti haulikkonsa tuvasta.	510355	510381	lehtonen1910a	2	26
Nu ja miitä?	107212	107224	jarnefelt1913a	2	12
Nujertaa hänet.	496960	496975	lehtonen1910a	1	15
Nukuttaa niinkuin muukin työ.	95494	95523	lehtonen1910a	3	29
Nuo mahtavat kirjat, Cervantes, Rabelais, Tolstoi.	766779	766829	lehtonen1910a	5	50
Nuo Rosinan kengätkin kiljuvat kuin mitkä.	282802	282844	lehtonen1910a	5	42
Nuoremmat puukhollarit ovat taempana apteekissa.	273621	273669	lehtonen1910a	4	48
Nuori olet, tee työtä, sanovat.	27540	27571	canth1886a	4	31
Nuori paroonitar oli komea, ylhäissukuinen, mielevä.	128251	128303	jarnefelt1916a	5	52
Nuori vielä.	243108	243120	lehtonen1910a	1	12
Nuoruuden rakkaus leimahti hänessä.	57723	57758	lassila1910a	3	35
Nuuskivat nokkaansa kaikki hänen kuljeskelunsa.	65405	65452	lehtonen1910a	4	47
Nykyisiä tuttujani ei allekirjoittaja voinut olla.	139164	139214	jarnefelt1916a	5	50
Nymark ja Alma menivät ulos verannalle.	147154	147193	canth1886a	5	39
Nymark katseli häntä ja kieritteli huulipartaansa.	201895	201945	canth1886a	5	50
Nymark kohotti keppiään.	143018	143042	canth1886a	2	24
Nymark nauroi.	184750	184764	canth1886a	1	14
Nymark odotti häntä salissa.	162205	162233	canth1886a	3	28
Nymark oli kerskaillut hyvästä kauneuden-aististaan.	169439	169491	canth1886a	4	52
Nymark puhutteli talonväkeä.	199932	199960	canth1886a	2	28
Nymark sanoi jäähyväiset ja läksi.	155610	155644	canth1886a	4	34
Nymark taas olisi yönhaltijana.	185025	185056	canth1886a	3	31
Nymark vetäisi sen lähemmäksi.	170807	170837	canth1886a	3	30
Nyrkinkö kokoisia?	196955	196973	lehtonen1910a	1	18
Nyt alan juosta, keveämpi ollakseni.	126512	126548	jarnefelt1913a	4	36
Nyt ei meillä enää ole hätää.	227075	227104	canth1886a	5	29
Nyt en enää halua.	780800	780818	lehtonen1910a	3	18
Nyt en missään tapauksessa sinua auta.	162028	162066	canth1886a	5	38
Nyt erottaa Ananias miehen naaman.	528800	528834	lehtonen1910a	4	34
Nyt hälistään hetki herroja vastaan.	453457	453493	lehtonen1910a	4	36
Nyt hän katsoo ällistellen naisiin.	723982	724017	lehtonen1910a	4	35
Nyt hän kumminkin tuli.	127557	127580	canth1886a	3	23
Nyt hän matkii kaikua.	84900	84922	lehtonen1910a	3	22
Nyt hän muistaa jokaisen kivenkin.	262943	262977	lehtonen1910a	4	34
Nyt hän nousee ja kättelee Rosinaa.	304576	304611	lehtonen1910a	5	35
Nyt hän on jo melkein valmis.	106363	106392	lehtonen1910a	5	29
Nyt hän raivostuu.	174085	174103	lehtonen1910a	2	18
Nyt hän ymmärsi nuo katseet.	192605	192633	canth1886a	4	28
Nyt he menevät perätysten rannalle.	647885	647920	lehtonen1910a	4	35
Nyt he soutavat edelleen.	795135	795160	lehtonen1910a	3	25
Nyt huomaa Jopi, ettei Malakiasta näy.	152678	152716	lehtonen1910a	5	38
Nyt huomaa pikku Jopi moottorin.	535357	535389	lehtonen1910a	4	32
Nyt jatkoivat he taas Kenosen kehumista.	268487	268527	lassila1910a	5	40
Nyt jo illat pimenevät.	670173	670196	lehtonen1910a	3	23
Nyt jo mammankin täytyy se myöntää.	141926	141961	jarnefelt1916a	5	35
Nyt Jöije tuli oikein intoihinsa.	58973	59006	jarnefelt1916a	4	33
Nyt juoksuttaa Rosina sille maitovatia aitasta.	42421	42468	lehtonen1910a	5	47
Nyt käy juttu jo rauhallisemmin.	561351	561383	lehtonen1910a	4	32
Nyt kiskoo hän juurineen pois seipäätkin.	383843	383884	lehtonen1910a	5	41
Nyt kuuluu airojen vingahtelua.	658339	658370	lehtonen1910a	3	31
Nyt kuuluukin Malakiaksen ääni aittojen takaa.	76323	76369	lehtonen1910a	5	46
Nyt Lyygia huomaa.	540031	540049	lehtonen1910a	2	18
Nyt näen vihdoin Jöijeni.	185153	185178	jarnefelt1916a	3	25
Nyt näkyy piha.	214108	214123	jarnefelt1916a	2	15
Nyt nauroivat kaikki.	621197	621218	lehtonen1910a	2	21
Nyt ne alkavat illat pimetä.	306316	306344	lehtonen1910a	4	28
Nyt ne hajuvedet ovat haihtuneet.	467091	467124	lehtonen1910a	4	33
Nyt nousee hän portaita.	558588	558612	lehtonen1910a	3	24
Nyt nousee suuri hälinä.	18911	18935	jarnefelt1916a	3	24
Nyt nuolaisevat liekit kivijalan rappauksen mustaksi.	507368	507421	lehtonen1910a	5	53
Nyt olen myöhästynyt, ajattelin.	12662	12694	jarnefelt1916a	3	32
Nyt oli heillä piiputkin matkassa.	228274	228308	lassila1910a	4	34
Nyt oli Jussi kiitollinen Antille.	128856	128890	lassila1910a	4	34
Nyt oli mitta täysi.	24158	24178	jarnefelt1913a	3	20
Nyt olisi Rosinan pyydettävä niitä verenpuhdistustippoja.	279028	279085	lehtonen1910a	5	57
Nyt ollaan Putkinotkossa ruokalevolla.	465266	465304	lehtonen1910a	3	38
Nyt on hattu syvällä toisella korvallisella.	331687	331731	lehtonen1910a	5	44
Nyt on Hurja jätetty kotiin.	791946	791974	lehtonen1910a	4	28
Nyt on riita valmis.	100875	100895	lehtonen1910a	3	20
Nyt on tullut sinun vuorosi.	139090	139118	jarnefelt1913a	4	28
Nyt ovat Hankoniemessä.	6162	6185	jarnefelt1913a	2	23
Nyt ovat kengät ihan entisellä paikallaan.	594503	594545	lehtonen1910a	5	42
Nyt piti Käkriäisen puuhata rivakasti.	526367	526405	lehtonen1910a	4	38
Nyt punertaa vastaranta.	626939	626963	lehtonen1910a	2	24
Nyt rientää Käkriäinen jo mäen harjalla.	524099	524139	lehtonen1910a	5	40
Nyt rientää Rosina pihan halki aittaan.	693305	693344	lehtonen1910a	5	39
Nyt saunan ovea avataan.	734757	734781	lehtonen1910a	3	24
Nyt se juoksee Sohvin ohitse.	526898	526927	lehtonen1910a	4	29
Nyt se katosi riihen pimeyteen.	730920	730951	lehtonen1910a	4	31
Nyt se neiti voihki ja siunaili.	341766	341798	lehtonen1910a	5	32
Nyt se on lakannut.	610772	610791	lehtonen1910a	3	19
Nyt se Saara makaa täällä.	55848	55874	lehtonen1910a	4	26
Nyt se taas purskuttaa.	258153	258176	lehtonen1910a	3	23
Nyt täytyy Rosinankin hypähtää paikaltaan.	123762	123804	lehtonen1910a	4	42
Nyt tiedän minne mennään.	127600	127625	jarnefelt1913a	3	25
Nyt tiukkuu kukkien varsista ruskeaa tervaa.	583934	583978	lehtonen1910a	5	44
Nyt tulee hän saunaan.	700682	700704	lehtonen1910a	3	22
Nyt tulee koivikkoa.	181262	181282	lehtonen1910a	2	20
Nyt tulee Lyygia kuistille.	762998	763025	lehtonen1910a	3	27
Nyt tulee sisään Saara, kaupunginmatkalle pukeutuneena.	131620	131675	lehtonen1910a	5	55
Nyt tulevat lapset neidin viereen.	648680	648714	lehtonen1910a	4	34
Nyt tuli pitempi vaiti-olo.	149243	149270	lassila1910a	3	27
Nyt tuli.	545780	545789	lehtonen1910a	1	9
Nyt varmistui Anna Liisa lopullisesti.	261913	261951	lassila1910a	4	38
Nyt vasta loppusuoritukseni alkaa.	197323	197357	jarnefelt1916a	3	34
Nyt vasta tulee mummolle suunvuoro.	425417	425452	lehtonen1910a	4	35
Nyt, luulin, on onneksi kaikesta päästy.	62097	62137	jarnefelt1913a	5	40
Nyt, mikäs tuli.	503638	503654	lehtonen1910a	2	16
Nytkin on vielä kaupungissa.	29965	29993	lehtonen1910a	3	28
Nytkin teki hän niin.	169917	169938	lassila1910a	3	21
Nyykäyttelee taas päätänsä.	159222	159249	jarnefelt1913a	2	27
Odotahan.	767857	767866	lehtonen1910a	0	9
Odotapas, helvetti.	491331	491350	lehtonen1910a	1	19
Odotapas, kun repäisen sinua pääkarvoista.	82844	82886	lehtonen1910a	4	42
Odotapas.	101816	101825	lehtonen1910a	0	9
Odottiko, että hän ensin nukkuisi?	133511	133545	canth1886a	4	34
Öh-höh.	701913	701920	lehtonen1910a	0	7
Ohkasen sadenutun vaan otat päällesi?	187774	187811	canth1886a	4	37
Ohuet sääret vilkkuvat lyhyen hameen alta.	539705	539747	lehtonen1910a	5	42
Oikea herra.	769982	769994	lehtonen1910a	1	12
Oikeaa kylpemistä.	720234	720252	lehtonen1910a	1	18
Oikeanpuoleisella ovelia: Anton, teetä, ole hyvä.	106374	106423	jarnefelt1913a	5	49
Oikeanpuoleisessa eteisessä palaa pieni seinälamppu.	137350	137402	jarnefelt1913a	4	52
Oikeastaan teidän pitäisi ylpeillä heidän kiusastaan.	197621	197674	canth1886a	5	53
Oikein helpottavalle tuntui Ullasta.	88315	88351	pakkala1895a	3	36
Oikein hyvältä tuntuu tässä kumpsia.	636731	636767	lehtonen1910a	4	36
Oikein minua hävettää.	163283	163305	jarnefelt1916a	2	22
Oikein moottorilla, yhä pöyhkeämmästi.	546065	546103	lehtonen1910a	3	38
Oikein tuntui raskaalle helmassa.	87619	87652	pakkala1895a	3	33
Oikeinko se on ryökkinä?	249136	249160	lehtonen1910a	3	24
Oikeinpa komennella heitä.	768033	768059	lehtonen1910a	2	26
Oikoo tytön tukkaa ja jokeltelee hänelle.	648999	649040	lehtonen1910a	5	41
Ole itse pikisilmä.	227343	227362	lehtonen1910a	2	19
Olen hänet ymmärtänyt liian myöhään, Paavali.	144842	144887	jarnefelt1913a	5	45
Olen kuullut, herr Befallningsman.	100031	100065	jarnefelt1913a	3	34
Olen minä.	369046	369056	lehtonen1910a	1	10
Olen sellainen kuin olen.	156145	156170	jarnefelt1916a	3	25
Olen tappanut.	110122	110136	jarnefelt1913a	1	14
Olen valvonut koko yön.	182309	182332	canth1886a	3	23
Olenhan häntä torunut.	779093	779115	lehtonen1910a	2	22
Olenko sittenkin kiihdyksissä?	93069	93099	jarnefelt1916a	2	30
Olet kaunis.	31478	31490	kilpi1903a	1	12
Olethan ihan lävitse uupunut.	76706	76735	canth1886a	3	29
Oletko sinä kylmä niinkuin sanotaan?	154331	154367	jarnefelt1913a	4	36
Oletpa tosiaan lapsellinen.	117532	117559	canth1886a	2	27
Olga heti suostui heidän esitykseensä.	25676	25714	pakkala1895a	4	38
Oli antanut Muttiselle selkään.	595433	595464	lehtonen1910a	3	31
Oli ennenkin mennyt vintistä ikkunan kautta.	76140	76184	pakkala1895a	5	44
Oli hän koettanut katkeria tunteitaan hallita.	126666	126712	canth1886a	5	46
Oli kilpajuoksu.	8345	8361	pakkala1895a	1	16
Oli lihaa pussissa, ostettua.	627517	627546	lehtonen1910a	3	29
Oli niin outoa kaikki.	107805	107827	pakkala1895a	3	22
Oli niitä nyt niin sääli.	112617	112642	pakkala1895a	4	25
Oli ollut täällä Putkinotkossa.	653477	653508	lehtonen1910a	3	31
Oli ollut talvi.	676876	676892	lehtonen1910a	2	16
Oli pimeää ja hiljaista.	230665	230689	canth1886a	3	24
Oli pitkä äänettömyys.	84886	84908	jarnefelt1913a	2	22
Oli siinä voimaa liikkeellä.	233112	233140	lassila1910a	3	28
Oli sillä ennenkin rouva, sitä kiusaamassa.	249267	249310	lehtonen1910a	5	43
Oli syksy.	212881	212891	lehtonen1910a	1	10
Oli taas puhuttu ja kehuttu.	31320	31348	lassila1910a	4	28
Oli, rouva.	90861	90872	jarnefelt1913a	1	11
Olihan häntä pyydetty lehmiä parantamaan.	359969	360010	lehtonen1910a	4	41
Olihan kartanolla päivällä pienet tikapuut.	108771	108814	pakkala1895a	4	43
Olihan niissä eilen siianpoikia ja muuta.	111742	111783	lehtonen1910a	5	41
Olihan se kärpänen?	127675	127694	pakkala1895a	2	19
Olihan sinne nyt tupakat saatu.	710027	710058	lehtonen1910a	4	31
Olihan Vappu nöyrä.	61876	61895	pakkala1895a	2	19
Oliko Martti siis rakastunut vai ei?	114652	114688	jarnefelt1916a	5	36
Oliko se kumminkin totta?	212716	212741	canth1886a	3	25
Olikohan se herra jo saunassa?	706891	706921	lehtonen1910a	4	30
Olikohan tuolla jotain samanlaista kaipuuta?	72027	72071	jarnefelt1916a	4	44
Olin hyvilläni, etteivät he ehtoja täyttäneet.	772749	772795	lehtonen1910a	5	46
Olin maailmassa yksin.	65182	65204	jarnefelt1913a	2	22
Olin olevinani tanssijaisissa.	142409	142439	jarnefelt1913a	2	30
Olin rakastunut hurjastelevaan, rajuun luutnanttiin.	8960	9012	jarnefelt1913a	4	52
Olinhan vain vaiti.	230804	230823	jarnefelt1916a	2	19
Olinko minä mikään lapsensurmaaja?	66751	66785	jarnefelt1913a	3	34
Olinkohan minä mikään hänen pelastajansa?	17512	17553	jarnefelt1913a	4	41
Olisi Leja, joka tuudittelee jo lasta.	512070	512108	lehtonen1910a	5	38
Olisiko sinuna, uneksuva Narkissos?	72940	72975	kilpi1903a	3	35
Olisiko sitä kaupunkia ja maata maanpäällä?	22398	22441	kilpi1903a	5	43
Olisikohan Rosina?	409390	409408	lehtonen1910a	1	18
Olisin kuin keltiäispesässä.	311531	311559	lehtonen1910a	2	28
Olisivatko ne tosiaan niityllä?	421097	421128	lehtonen1910a	3	31
Olivat menneet portille katsomaan hänen jälkeensä.	20869	20919	pakkala1895a	5	50
Olivat silloin nuoria.	660450	660472	lehtonen1910a	2	22
Olivatkohan he jotakin syntiä tehneet?	51633	51671	pakkala1895a	4	38
Olkihattu päässä, pehmeä kuin pussi.	548406	548442	lehtonen1910a	4	36
Olkoon siis unohdettu.	638420	638442	lehtonen1910a	2	22
Olkoot ja antakoot lahjansa.	4362	4390	pakkala1895a	3	28
Ollaan hiljaa.	715724	715738	lehtonen1910a	1	14
Ollaan pihalla.	258427	258442	jarnefelt1916a	1	15
Oltiin ihan ääneti, veistettiin ja kehrättiin.	31663	31709	lassila1910a	5	46
Oltiin kuin käsille lyötyjä.	69452	69480	pakkala1895a	3	28
Oltiin välillä ääneti.	223213	223235	lassila1910a	2	22
Olutrännin rengiltä.	270183	270203	lehtonen1910a	1	20
Oma se pitäisi paikka olla.	187835	187862	lehtonen1910a	4	27
Omaa syöntiään ei Rosina muista.	756591	756623	lehtonen1910a	4	32
Omaanihan minäkin tahdon.	785752	785777	lehtonen1910a	2	25
Oman itsenne tähden, näettekö.	111352	111382	canth1886a	3	30
Oman tyttärensä, joka on riuska.	73129	73161	lehtonen1910a	4	32
Omiahan tässä ollaan.	789786	789807	lehtonen1910a	2	21
Omin neuvoin he ottelevat täällä.	782483	782516	lehtonen1910a	4	33
On hiljaista.	615336	615349	lehtonen1910a	1	13
On hiljaista.	658844	658857	lehtonen1910a	1	13
On hiljaista.	69781	69794	kilpi1903a	1	13
On hunsvotteja muuallakin.	762446	762472	lehtonen1910a	2	26
On jo aikansa seisonut tiskin takana.	765763	765800	lehtonen1910a	5	37
On käännettävä tarina muualle.	451243	451273	lehtonen1910a	3	30
On kesä, vanhoille etenkin hyvä.	313379	313411	lehtonen1910a	4	32
On kuumaa.	283747	283757	lehtonen1910a	1	10
On lämmintä, onpa kuumakin eräistä.	68557	68592	lehtonen1910a	4	35
On lämmintä.	175704	175716	lehtonen1910a	1	12
On mahdollista, että Juutas myy Putkinotkon.	785505	785549	lehtonen1910a	5	44
On mitä on.	47240	47251	lehtonen1910a	2	11
On muuta.	278248	278257	lehtonen1910a	1	9
On niitä kunnanmaksujen rästejä nytkin.	405914	405953	lehtonen1910a	4	39
On nyt tuo iltakin mennyt myöhäiseen.	695348	695385	lehtonen1910a	5	37
On ollut omiakin töitä.	29023	29046	lehtonen1910a	3	23
On puoliyön aika.	137404	137421	jarnefelt1913a	2	17
On raukenemista, kauneudeksi raukenemista joka jäsenessään.	75370	75429	kilpi1903a	5	59
On se nyt saarnaaminen.	514813	514836	lehtonen1910a	3	23
On se toki leppyväinen mies.	562599	562627	lehtonen1910a	4	28
On sen mieli kiitollinen ystäville.	300229	300264	lehtonen1910a	4	35
On siinä kiikaroiminen, Jopi.	459588	459617	lehtonen1910a	3	29
On sitä vielä kumpsimista.	704494	704520	lehtonen1910a	3	26
On sitä.	278297	278305	lehtonen1910a	1	8
On syksy.	782182	782191	lehtonen1910a	1	9
On taas myyriä kaivellut.	229291	229316	lehtonen1910a	3	25
On tultu kaupunkiin, muka.	258268	258294	lehtonen1910a	3	26
On välistä annettu.	251578	251597	lehtonen1910a	2	19
Ongelle on jouduttava.	611180	611202	lehtonen1910a	2	22
Onhan ensi yö valvomista.	636282	636307	lehtonen1910a	3	25
Onhan Lejan mentävä lehmiä noutamaan.	633046	633083	lehtonen1910a	4	37
Onhan niillä rikkailla, katsellakseen niitä, istuskellessaan.	283182	283243	lehtonen1910a	5	61
Onhan niitä muitakin tuulastajia.	763538	763571	lehtonen1910a	3	33
Onhan se varsin mahdollista.	356147	356175	lehtonen1910a	3	28
Onhan siinä talossa hyvät nurmet.	115297	115330	lassila1910a	4	33
Onhan sillä jo ikää.	446087	446107	lehtonen1910a	3	20
Onhan suomalaisissa lutikoita.	667533	667563	lehtonen1910a	2	30
Onhan tässä maailmassa tilaa useammillekin.	502815	502858	lehtonen1910a	4	43
Onko elämä sulouden ja kammotuksen kivisfinxi?	101764	101810	kilpi1903a	5	46
Onko hän kipjä?	115262	115277	jarnefelt1913a	2	15
Onko hän mitenkään mielenkiinnoista köyhä, epälahjakas?	250680	250735	jarnefelt1916a	5	55
Onko mummo palanut?	280799	280818	lehtonen1910a	2	19
Onko puutarha?	5231	5245	jarnefelt1913a	1	14
Onko se herra nyt siellä?	248308	248333	lehtonen1910a	4	25
Onko se kalevalaisen metsän sinipiika?	608939	608977	lehtonen1910a	4	38
Onko se siellä nyt?	306475	306494	lehtonen1910a	3	19
Onko se sydämen suloista halajoimisen haikeutta?	33989	34037	kilpi1903a	5	48
Onko sillä patteja, hevosella?	279934	279964	lehtonen1910a	3	30
Onko tuo Mauno?	492471	492486	lehtonen1910a	2	15
Onkohan ihmisen hyvä paeta suruja?	91811	91845	jarnefelt1913a	4	34
Onkohan joku sairastunut, ajattelin.	282329	282365	jarnefelt1916a	3	36
Onkohan se tyttö avannut hunajapurkin verannalla?	583405	583454	lehtonen1910a	5	49
Onkos se Hellan telttu pippa?	520962	520991	lehtonen1910a	4	29
Onkos se tyhjä?	710914	710929	lehtonen1910a	2	15
Onkos sillä nyt rouvaa?	248479	248502	lehtonen1910a	3	23
Onneksi kone samassa alkoi käydä.	272118	272151	jarnefelt1916a	4	33
Onnellisena kauneutena häilyilee koko ihmisen tila.	11918	11969	kilpi1903a	5	51
Onnestahan minä itken.	292910	292932	jarnefelt1916a	2	22
Onneton rakkaus.	123747	123763	jarnefelt1916a	1	16
Onpa hän koettanut, ettei niitä tulisikaan.	53752	53795	lehtonen1910a	5	43
Onpa hänkin maalta kotoisin.	651408	651436	lehtonen1910a	3	28
Onpa Muttisella hyvä pöydässä.	601138	601168	lehtonen1910a	3	30
Onpa suunnitellut tarkoin jo kaikki mielessään.	482805	482852	lehtonen1910a	5	47
Opettajille tuli tärkeäksi saada syylliset ilmi.	51192	51240	jarnefelt1913a	5	48
Osaa ymmärtää ja rakastaa muka todella.	589736	589775	lehtonen1910a	5	39
Osaatko sinä vielä tanssia?	542354	542381	lehtonen1910a	3	27
Osasi, Jumalan luoma.	388112	388133	lehtonen1910a	2	21
Osta niillä vehnäsiä, tuolta kioskeista.	261513	261553	lehtonen1910a	4	40
Ostaa kaikki maat.	453106	453124	lehtonen1910a	2	18
Osti muka kangasta meidän lapsille.	249405	249440	lehtonen1910a	4	35
Otan toisen tunnesävyn.	180362	180385	jarnefelt1916a	2	23
Otatteko mukaan.	233906	233922	lehtonen1910a	1	16
Otti pisarani?	41255	41269	jarnefelt1913a	1	14
Outo ei löytäisi noissa sokkeloissa minnekään.	2451	2497	lehtonen1910a	5	46
Outoja naamaria kokoontui Alman ympärille.	189861	189903	canth1886a	4	42
Ovat ne lyöneet muutkin.	323189	323213	lehtonen1910a	3	24
Ovatko ihmiset ihanammat Athenassa?	25595	25630	kilpi1903a	3	35
Ovella katsahdin vielä kerran heihin.	194613	194650	jarnefelt1916a	4	37
Oven suussa hän istuskelee, möyhennetyllä tuolilla.	329894	329945	lehtonen1910a	5	51
Ovi hänen jälkeensä auki.	99418	99443	jarnefelt1913a	3	25
Ovi kävi ja hän vavahti.	126556	126580	pakkala1895a	4	24
Ovikellon soitto kansliahuoneen eteisestä.	102955	102997	jarnefelt1913a	3	42
Pää edeltä sukeltaiksen hän kahisevaan lepikkoon.	524504	524553	lehtonen1910a	5	49
Pää oli pönkitty ja aivot tympistyneet.	225091	225130	canth1886a	5	39
Pään oli sotkea.	717718	717734	lehtonen1910a	2	16
Päärakennuksen oven edessä oli tuoreita havuja.	80328	80375	jarnefelt1913a	5	47
Paarmatko niiden kimpussa hörrännevät?	420301	420339	lehtonen1910a	3	38
Pääseehän aidan yli.	108750	108770	pakkala1895a	2	20
Pääsi vihdoin sentään kamreerin talon kohdalle.	17107	17154	canth1886a	5	47
Pääskysten pesien putoamisesta on Juutaksellekin merkkiä.	463765	463822	lehtonen1910a	5	57
Päässeensä makaamistuurilta.	636392	636420	lehtonen1910a	1	28
Päätin tehdä.	286002	286015	jarnefelt1916a	1	13
Paavali kulta, mistä me puhelisimme?	142284	142320	jarnefelt1913a	4	36
Paavali, älä jätä minua.	142202	142226	jarnefelt1913a	3	24
Paavalin äidin asunto.	136706	136728	jarnefelt1913a	2	22
Pahat tästä tulee.	503655	503673	lehtonen1910a	2	18
Pahotinko mielenne, Paavali?	158674	158702	jarnefelt1913a	2	28
Painanteihin alas, kankaille ylös hän kiertää.	216205	216251	lehtonen1910a	5	46
Päinvastoin.	5582	5594	jarnefelt1916a	0	12
Päivä lämpenee yhä.	219239	219258	lehtonen1910a	2	19
Päivä on mennyt, helteineen ja puuhineen.	756624	756665	lehtonen1910a	5	41
Päivä paistaa vuoreen.	610525	610547	lehtonen1910a	2	22
Päivä paistaa.	371704	371718	lehtonen1910a	1	14
Pakasti.	99005	99013	jarnefelt1916a	0	8
Pakkoko se on?	425177	425191	lehtonen1910a	2	14
Paksuposkinen Topi heillä oli haarojensa välissä.	24573	24622	lehtonen1910a	5	49
Paksuposkinen Topi tyrskähtää nauruun.	566445	566483	lehtonen1910a	3	38
Palakoon ensin sauna, ja sitten huvila.	505485	505524	lehtonen1910a	5	39
Palatessaan pöydän luo hiipi hän varpaillaan.	30875	30920	pakkala1895a	5	45
Paljasjaloin hän siinä seisoi ja onki.	668239	668277	lehtonen1910a	5	38
Paljastaa kuopan pohjan.	395580	395604	lehtonen1910a	2	24
Paljonko pitää?	366505	366520	lehtonen1910a	1	15
Paljunkiako?	280138	280150	lehtonen1910a	0	12
Pane mieleesi.	145212	145226	jarnefelt1913a	1	14
Pannaan entisten jatkoksi.	494288	494314	lehtonen1910a	2	26
Pannaanko Kallen saunasuolaa?	280020	280049	lehtonen1910a	2	29
Pantaisiko panska luusalvaa?	279965	279993	lehtonen1910a	2	28
Pantiin toimeen ankaroita tutkistelemuksia.	51241	51284	jarnefelt1913a	3	43
Papattaa kuin monttööri vene.	413588	413617	lehtonen1910a	3	29
Pappa matkusti yksin.	91157	91178	jarnefelt1916a	2	21
Parasta olla kuitenkin täällä.	412600	412630	lehtonen1910a	3	30
Parempi jos itse olisit kertonut heti.	224774	224812	canth1886a	5	38
Parempi olisi ollut Leea.	591674	591699	lehtonen1910a	3	25
Parhaita kirjojakin.	782778	782798	lehtonen1910a	1	20
Pari ikkunoista on auki.	328500	328524	lehtonen1910a	3	24
Parissa talossa hän kävi kysymässä renginpaikkaa.	654372	654421	lehtonen1910a	5	49
Parooni ilmestyi vihdoin saliin.	35914	35946	jarnefelt1916a	3	32
Parooni kysyi, olenko tulkinnut kaiken.	44473	44512	jarnefelt1916a	4	39
Paroonitar syleili minua toistamiseen.	26381	26419	jarnefelt1916a	3	38
Paroonittaren tapasin hänen sisimmästä huoneestaan.	15604	15655	jarnefelt1916a	4	51
Pässi hyökkää.	685316	685330	lehtonen1910a	1	14
Pässi päkkää, ja Sanelma kirkaisee.	686252	686287	lehtonen1910a	4	35
Pässikö on puskenut, Topi?	86416	86442	lehtonen1910a	3	26
Pässikö?	432080	432088	lehtonen1910a	0	8
Pässin silmät kiiluivat mustina päässä.	78971	79010	lehtonen1910a	4	39
Pastori kuitenkin joutui ennen perille.	78972	79011	canth1886a	4	39
Pateettista niinkuin mikäkin sankariruno.	784043	784084	lehtonen1910a	3	41
Paussi.	107956	107963	jarnefelt1913a	0	7
Pelkään sen unen uudistuvan.	142255	142283	jarnefelt1913a	3	28
Pellolta kuuluu silloin yöllä möreä hyräily.	50025	50069	lehtonen1910a	5	44
Pelosta ei ollut jälkeäkään.	81115	81143	jarnefelt1916a	3	28
Pelotti, että äiti ei laittaisikaan sitten.	47015	47058	pakkala1895a	5	43
Pennut kiljuvat.	86210	86226	lehtonen1910a	1	16
Pennut ovat tulleet ovelta katselemaan.	107087	107126	lehtonen1910a	4	39
Pennut.	420829	420836	lehtonen1910a	0	7
Pentuja ei näy pihalla.	421073	421096	lehtonen1910a	3	23
Perääntyen minä karahutan takajaloilleni.	125738	125779	jarnefelt1913a	3	41
Perämiehen iso rahalaukku kalisee jo tuolla.	250164	250208	lehtonen1910a	5	44
Perhe on vaiti, jörösti ja loukkaantuneena.	143902	143945	lehtonen1910a	5	43
Perheestä on osa kömpinyt saunasta sinne.	68201	68242	lehtonen1910a	5	41
Pertan Sanelma on siihen aivan valmis.	570307	570345	lehtonen1910a	5	38
Pertan vuoksi jäi Juutaksen kysely tekemättä.	708065	708110	lehtonen1910a	5	45
Pertta heitä vähän ärsytti.	486786	486813	lehtonen1910a	3	27
Pertta ja iso Sanelma haravoivat.	624615	624648	lehtonen1910a	4	33
Pertta Kinnunen näet tahtoi syömistä.	742751	742788	lehtonen1910a	4	37
Pertta vaikenee tuokioksi.	696432	696458	lehtonen1910a	2	26
Perunat ovat aikoja sitten keitetyt.	462644	462680	lehtonen1910a	4	36
Perunat pyörähtävät kuitenkin maahan.	121298	121335	lehtonen1910a	3	37
Petäjä oli melkein hänen kokoisensa.	585636	585672	lehtonen1910a	4	36
Petäjät suhisevat hiljaisessa tuulessa.	112766	112805	lehtonen1910a	3	39
Pettymyksen viha sälähti mielessä.	30307	30341	pakkala1895a	3	34
Petu kiiruusti pakoon, että hame viuhkasi.	35597	35639	canth1886a	5	42
Petu meni ja nykäisi häntä takaa.	35290	35323	canth1886a	5	33
Petu nykäisi toisen kerran.	35408	35435	canth1886a	3	27
Petuko antoi?	9693	9706	canth1886a	1	13
Pian joudutaan ulapalle.	2935	2959	lehtonen1910a	2	24
Pian on kaikki tipot viety.	435313	435340	lehtonen1910a	4	27
Pian se voi täälläkin romahtaa.	511524	511555	lehtonen1910a	4	31
Pianpa se kävikin.	75429	75447	canth1886a	2	18
Pidellyt lauhkeasti kuin pesusienellä.	779134	779172	lehtonen1910a	3	38
Pieksää, ja silmät säkenöivät vimmasta.	120867	120906	lehtonen1910a	4	39
Pienestä pitäen ei, muuta kuin sairautta.	34659	34700	canth1886a	5	41
Pieni poika herkeää itkemästä.	81912	81942	lehtonen1910a	3	30
Pihalla kuorsataan ja nukutaan.	475486	475517	lehtonen1910a	3	31
Pihalle jää Lyygia.	648217	648236	lehtonen1910a	2	19
Piilee kuin mäyrä omassa kolossaan.	290082	290117	lehtonen1910a	4	35
Piippu hampaissa hän oli niittänyt.	705295	705330	lehtonen1910a	4	35
Piippu lerpatti hampaissa ihan tipahtamaisillansa.	229510	229560	lassila1910a	4	50
Piippu putoaa sammalikkoon.	382367	382394	lehtonen1910a	2	27
Piippu suussa mörötti yksinään tuossa penkillä.	520174	520221	lehtonen1910a	5	47
Piippu toki löytyi.	382554	382573	lehtonen1910a	2	19
Piippu turisee.	382084	382099	lehtonen1910a	1	15
Piippu vain lepatti putoamistansa odotellen.	1835	1879	lassila1910a	4	44
Piisaa tämä minulle.	722680	722700	lehtonen1910a	2	20
Pikku Anni väänteli itseään kätkyessä.	51853	51891	canth1886a	4	38
Pikku Luukas se siellä itkee.	223351	223380	lehtonen1910a	4	29
Pikku Sanelma asettuu heti nenälleen maahan.	642913	642957	lehtonen1910a	5	44
Pikku Sanelma ei vastaa.	539220	539244	lehtonen1910a	3	24
Pikku Sanelma hihittää ja hyppii.	724494	724527	lehtonen1910a	4	33
Pikku Sanelma hihkuu ja hyppelee.	401229	401262	lehtonen1910a	4	33
Pikku Sanelma ja Topi juoksevat pihalle.	693263	693303	lehtonen1910a	5	40
Pikku Sanelma seisoo koivet pystyssä.	643494	643531	lehtonen1910a	4	37
Pikku Sanelma suuttuu.	645579	645601	lehtonen1910a	2	22
Pikku Sanelma tahtoo kahvia.	441895	441923	lehtonen1910a	3	28
Pikku Sanelma tirskuu.	459178	459200	lehtonen1910a	2	22
Pikku Sanelmakaan ei tirsku.	725385	725413	lehtonen1910a	3	28
Pikku Sanelmakin hiipii yhteiselle onkipaikalle.	626749	626797	lehtonen1910a	4	48
Pikku Sanelman ja Jopin.	663570	663594	lehtonen1910a	3	24
Pikku sisko lyö yhä.	120945	120965	lehtonen1910a	3	20
Pilkistelee joka taholle.	259446	259471	lehtonen1910a	2	25
Pilvenhattarat liikkuvat riemullisina ilmavalla taivaalla.	223074	223132	lehtonen1910a	4	58
Pilvet ovat kuin ruusuisia vivahteita helmiäisissä.	650553	650604	lehtonen1910a	5	51
Pilvistä se vivahdus tulee.	610849	610876	lehtonen1910a	3	27
Pimeä metsä raikuu.	788465	788484	lehtonen1910a	2	19
Piruako se siellä tekee?	168843	168867	lehtonen1910a	3	24
Pistävä ja voimakas haju.	132365	132390	lehtonen1910a	3	25
Pitää köllötellä syrjässä.	587244	587270	lehtonen1910a	2	26
Pitää mennä ottamaan metsästä äyskäri.	171918	171956	lehtonen1910a	4	38
Pitää nauttia siitä, mitä vielä saa.	587207	587243	lehtonen1910a	5	36
Pitää panna pojat ja tytöt työhön.	390945	390979	lehtonen1910a	5	34
Pitäähän niille rakkaille antaa.	517530	517562	lehtonen1910a	3	32
Pitääkös sille pienelle tittiä?	520649	520680	lehtonen1910a	3	31
Pitäisi jo toki olla vähän ymmärtäväisempi.	157062	157105	jarnefelt1913a	5	43
Pitäisi se Rosina saada leppymään.	145250	145284	lehtonen1910a	4	34
Pitäisi sitä köyhiä auttaa.	74914	74941	lehtonen1910a	3	27
Pitäisikö sillekin ostaa lappu?	250263	250294	lehtonen1910a	3	31
Pitäköön Saara itsestään huolen.	250420	250452	lehtonen1910a	3	32
Pite kesi alhalla.	99794	99812	jarnefelt1913a	2	18
Pitemmät ovat Martin, lyhemmät Jöijen, ajattelin.	101578	101627	jarnefelt1916a	5	49
Piti päivettyä ja saada jänteitä käsivarsiinsa.	62066	62113	jarnefelt1916a	5	47
Pitkän aikaa ja hiljaa.	257172	257195	lehtonen1910a	3	23
Pöh, pöh.	701921	701930	lehtonen1910a	1	9
Pohjiaan myöten heidän, oikein oma.	60568	60603	lehtonen1910a	4	35
Poika ei ole millänsäkään.	401169	401195	lehtonen1910a	3	26
Poika värisi vilusta ohkaisessa hameessaan.	30252	30295	canth1886a	4	43
Poika vetää miestä kiirehtimään.	257704	257736	jarnefelt1916a	3	32
Poika yhä parkui; pelkäsi hänelle annettavan.	10824	10869	canth1886a	5	45
Poikki heinäkarheiden.	500622	500644	lehtonen1910a	1	22
Pois kaikenlaisista kotoisista kärhäyksistä.	638795	638839	lehtonen1910a	3	44
Pois minä lähden täältä.	311391	311415	lehtonen1910a	3	24
Pois pateettisuus.	787677	787695	lehtonen1910a	1	18
Poissa pölyäviltä kaduilta, selluloosatehtaiden tuoksusta.	765536	765594	lehtonen1910a	4	58
Pojan riemu yltyi.	107344	107362	lassila1910a	2	18
Pojat hämmästyivät.	9192	9211	pakkala1895a	1	19
Pojat remahtivat nauramaan.	11429	11456	pakkala1895a	2	27
Pojatkin istuivat nyt hiljaa, yhdessä kohden.	74430	74475	canth1886a	5	45
Poliisia löi.	323175	323188	lehtonen1910a	1	13
Polttaa käsiä.	658829	658843	lehtonen1910a	1	14
Polttopuita hän kantaa, kahvinkeittoa varten.	314074	314119	lehtonen1910a	4	45
Polutonta rinnettä, sakeaan viidakkoon.	500756	500795	lehtonen1910a	3	39
Polvillaan hänen vieressään: Anton, koeta rauhoittua.	102158	102211	jarnefelt1913a	5	53
Porkin kasvot pöhöttivät veripunaisina.	238806	238845	lassila1910a	3	39
Porsaasta johtuivat ajatukset Kaisan taloon.	229013	229057	lassila1910a	4	44
Porsas alkoi telmää olilla.	228168	228195	lassila1910a	3	27
Porsas pyöräytti saparoaan ja poika riemuitsi.	107084	107130	lassila1910a	5	46
Porsas tuntui hänestä jo ihan läheiseltä.	138502	138543	lassila1910a	5	41
Porsas vingahteli.	112675	112693	lassila1910a	1	18
Porsas vinkui säkissä kuin syötävä.	136429	136464	lassila1910a	4	35
Porsas vinkui säkissä selässä.	152630	152660	lassila1910a	3	30
Porsas vinkui taas säkissä.	148251	148278	lassila1910a	3	27
Porsaskin joskus örähtelee.	689305	689332	lehtonen1910a	2	27
Poskesta näkyi, että hän vähä hymyili.	91926	91964	jarnefelt1916a	5	38
Posket olivat kalpeat ja katse sumea.	234286	234323	canth1886a	5	37
Poskia poltteli ja korvat humisivat.	62202	62238	pakkala1895a	4	36
Poskia poltteli.	37099	37115	pakkala1895a	1	16
Potatteja hän kuitenkin suosii erityisesti.	196039	196082	lehtonen1910a	4	43
Potkivat Maunon pois.	301978	301999	lehtonen1910a	2	21
Pöydän toisessa päässä istui Käkriäinen.	352110	352150	lehtonen1910a	4	40
Pöytä oli katettu verannalle.	110337	110366	canth1886a	3	29
Puhdistelee marjoja mummolle.	512210	512239	lehtonen1910a	2	29
Puhele kanssani etten nuku.	142227	142254	jarnefelt1913a	3	27
Puhkuvaa ruispuuroa, voisilmässä kastettua.	465162	465205	lehtonen1910a	3	43
Puhutaan siitä asiasta.	767881	767904	lehtonen1910a	2	23
Puhuttiin muista vähemmän tärkeistä asioista.	123139	123184	lassila1910a	4	45
Pujahdin sisään samaan ovensuljentaan.	15564	15602	jarnefelt1916a	3	38
Pujahtavat Muttisen ja Topin sivuitse sisälle.	670822	670868	lehtonen1910a	5	46
Punainen se on.	505286	505301	lehtonen1910a	2	15
Punainen tulikettu.	25920	25939	lehtonen1910a	1	19
Punaisessa mekossa.	505302	505321	lehtonen1910a	1	19
Punaisista pilvistä se hohtaa.	626320	626350	lehtonen1910a	3	30
Punertava se on ja korkea.	10410	10436	lehtonen1910a	4	26
Puoleen hintaan se putoaa ainakin.	376225	376259	lehtonen1910a	4	34
Puolitiessä mäkeä kääntyy hän yhtäkkiä.	234837	234876	lehtonen1910a	4	39
Puoshaan kärki puskee nuottakodan lahonneeseen salvaimeen.	534592	534650	lehtonen1910a	5	58
Puree hammasta ja kömpii ylös kuopasta.	397817	397856	lehtonen1910a	5	39
Pussin työntää hän lihavaan poveensa.	573134	573171	lehtonen1910a	4	37
Putkinotkon Käkriäinen ilostuu jälleen.	366540	366579	lehtonen1910a	3	39
Putkinotkon lammelle.	606388	606409	lehtonen1910a	1	21
Putkinotkon lehmätkin ammuvat nyt viidakossa lähellä.	403868	403921	lehtonen1910a	5	53
Putkinotkon mökille on varmaan tullut vieraita.	405688	405735	lehtonen1910a	5	47
Putkinotkosta?	349785	349799	lehtonen1910a	0	14
Puukolle olisi pitänyt maksaa.	345029	345059	lehtonen1910a	3	30
Puutos on julma.	252767	252783	lassila1910a	2	16
Puuttuu saunajuoma, tuoppi piimää.	698132	698166	lehtonen1910a	3	34
Pyörii, kaivaa sammalta.	383399	383423	lehtonen1910a	2	24
Pyörryttääkö?	223711	223724	canth1886a	0	13
Pyörtyiköhän Jopi?	717284	717302	lehtonen1910a	1	18
Pyrki sulamaan kaikki nauruun.	27116	27146	pakkala1895a	3	30
Pysyi siellä nurkan takana keinoa miettiäkseen.	561928	561975	lehtonen1910a	5	47
Pysykää nyt lähellä.	28393	28413	canth1886a	2	20
Pyydäpä sellaista neitiä mihinkään.	591546	591581	lehtonen1910a	3	35
Pyydettävä se on.	270908	270925	lehtonen1910a	2	17
Pyytää Topia tuomaan itselleen kodasta piimää.	720126	720172	lehtonen1910a	5	46
Qu'est ce que c'est donc?	104939	104964	jarnefelt1913a	4	25
Raatona.	182197	182205	lehtonen1910a	0	8
Rahatuusahan jäi kotiin.	263151	263175	lehtonen1910a	2	24
Rahojaan oli Jopi viipynyt rannalla tarkastamassa.	433277	433327	lehtonen1910a	5	50
Rakastaapa hän lapsiaan ja omaa sikaansa.	203233	203274	lehtonen1910a	5	41
Rakastanhan sinua koko sielullani.	134716	134750	canth1886a	3	34
Rakennukset ovat rinteellä, hiukan ylempänä rantaäyrästä.	7862	7919	lehtonen1910a	5	57
Rakkaasti oli Fanny silloin häneen katsellut.	589953	589998	lehtonen1910a	5	45
Rakkahin Hiljani, mitähän sinäkin minusta ajattelet?	169374	169426	jarnefelt1916a	5	52
Rannalla läpisevät haavat aamuviluisesti.	11369	11410	lehtonen1910a	3	41
Rannat alkoivat lipua vielä nopeammin ohitse.	79324	79369	jarnefelt1916a	5	45
Rannat kaikki kajahtelevat.	153465	153492	lehtonen1910a	2	27
Rannat laskeutuvat paikoittain pystysuorina veteen.	181892	181943	lehtonen1910a	4	51
Rauhaa minä tahdon.	766553	766572	lehtonen1910a	2	19
Rauhassa minä tahdon olla ja lueksia.	778946	778983	lehtonen1910a	5	37
Raukeana tahdottomana rauhana.	75687	75717	kilpi1903a	2	30
Räystäistä ei enää tippunut.	98976	99004	jarnefelt1916a	3	28
Rehevä on se heisi niinkuin nokkospehko.	115649	115689	lehtonen1910a	5	40
Rehtori kalpeni.	54020	54036	jarnefelt1913a	1	16
Reiästä pilkistelee Jopin tukka.	84466	84498	lehtonen1910a	3	32
Reipastelu onnistui Leppäselle aluksi vallan mainiosti.	33787	33842	jarnefelt1916a	5	55
Reisvänni hän on nimeltään.	289245	289272	lehtonen1910a	3	27
Reki vedetään hiljaa vajasta.	123371	123400	jarnefelt1913a	3	29
Repaleiset nuo ovat lapset.	203275	203302	lehtonen1910a	3	27
Repekka anelee taas voileipää.	517461	517491	lehtonen1910a	3	30
Repekka itkaisee taas.	640633	640655	lehtonen1910a	2	22
Repekka itkee tuvassa.	756299	756321	lehtonen1910a	2	22
Repekka ja Ester kinastelevat karamelleistä.	567541	567585	lehtonen1910a	4	44
Repekka ja Sanelma matkivat Topia.	642150	642184	lehtonen1910a	4	34
Repekka juoksee Hurjan kimppuun.	639817	639849	lehtonen1910a	3	32
Repekka kirkuu riemusta.	639936	639960	lehtonen1910a	2	24
Repekka matkii koiraa.	640081	640103	lehtonen1910a	2	22
Repekka pyörähtää ja vilkaisee Ananiakseen.	71007	71050	lehtonen1910a	4	43
Repekka tahtoo Moksin kiinni.	640448	640477	lehtonen1910a	3	29
Repekka tirkisteli pihalle nostettuna ensin aurinkoon.	70183	70237	lehtonen1910a	5	54
Repekkaa, Herran terttua.	325313	325338	lehtonen1910a	2	25
Repi aidan hovin lehmille auki.	345172	345203	lehtonen1910a	4	31
Repiä ne pitäisi kaikki pois.	504306	504335	lehtonen1910a	4	29
Reumatismi on niin sanoakseni sukuvika meissä.	6583	6629	jarnefelt1913a	5	46
Riemukas ja samalla alakuloinen laulu.	471426	471464	lehtonen1910a	4	38
Riemulla ne nyt ryntäsivät kaikki esille.	242286	242327	canth1886a	5	41
Rientää ulos haltioituneena äärimmilleen.	159703	159744	jarnefelt1913a	3	41
Riihen kupeelle sen lapset paimensivat.	202635	202674	lehtonen1910a	4	39
Riittäisiköhän sitä iloa nyt hyvinkin kauan?	764624	764668	lehtonen1910a	5	44
Ripatillakin ostattaa, vilskommipelillä.	453125	453165	lehtonen1910a	2	40
Ripatista on Konstalle hyödykkiä metsäkaupoissa.	340782	340830	lehtonen1910a	4	48
Ripatti on lurjus.	342526	342544	lehtonen1910a	2	18
Rippikoulun linnassa käynyt.	493068	493096	lehtonen1910a	2	28
Ristit ottivat uhkaavan muodon.	238955	238986	canth1886a	3	31
Riuhtoen hän sen sitoo.	385476	385499	lehtonen1910a	3	23
Rivakasti soutaa Rosina kapean salmen yli.	287011	287053	lehtonen1910a	5	42
Rohtojen avulla, ellei muuten.	221554	221584	canth1886a	3	30
Rosina ällistyy, ja puhkeaa hiljaiseen nauruun.	259607	259654	lehtonen1910a	5	47
Rosina ällistyy.	553386	553402	lehtonen1910a	1	16
Rosina avaa silmänsä.	510949	510970	lehtonen1910a	2	21
Rosina heiluttaa nyrkkiään, jossa kengät roikkuvat.	421895	421946	lehtonen1910a	5	51
Rosina huomaa siinä Jopin.	755382	755408	lehtonen1910a	3	26
Rosina innostuu, että onpas viisailla konstinsa.	309758	309806	lehtonen1910a	5	48
Rosina jää pihalle.	573452	573471	lehtonen1910a	2	19
Rosina juoksee siihen kesken kiireitään.	641650	641690	lehtonen1910a	4	40
Rosina juoksee sinne.	511994	512015	lehtonen1910a	2	21
Rosina juoksee ulos.	521989	522009	lehtonen1910a	2	20
Rosina käännähtää ihmeissään.	553236	553265	lehtonen1910a	2	29
Rosina käännähtää.	421730	421748	lehtonen1910a	1	18
Rosina Käkriäinen on hyvillään jauhoista.	426207	426248	lehtonen1910a	4	41
Rosina Käkriäisen ja lasten ääniä.	611693	611727	lehtonen1910a	4	34
Rosina Käkriäistä lähellä on paljon veneitä.	284535	284579	lehtonen1910a	5	44
Rosina katsoo hetken miesten menoa.	756144	756179	lehtonen1910a	4	35
Rosina koettaa sitä hyssytellä uneen.	520817	520854	lehtonen1910a	4	37
Rosina kulkee kantamuksineen ylemmäksi, Potamian taustalle.	288786	288845	lehtonen1910a	5	59
Rosina kuuntelee kujalla saunalle päin.	734573	734612	lehtonen1910a	4	39
Rosina melkein itkee kiukusta.	108378	108408	lehtonen1910a	3	30
Rosina menee lähemmäksi Maunoa.	573641	573672	lehtonen1910a	3	31
Rosina menee ruokakonttoriin.	517563	517592	lehtonen1910a	2	29
Rosina murahtaa jotain mummolle.	512613	512645	lehtonen1910a	3	32
Rosina näytti huolestuneelta.	707733	707762	lehtonen1910a	2	29
Rosina näytti sen minulle.	689406	689432	lehtonen1910a	3	26
Rosina odottaa jännityksessä.	550329	550358	lehtonen1910a	2	29
Rosina oli siepannut ne häneltä pois.	740831	740868	lehtonen1910a	5	37
Rosina oli vilkaissut ulos ikkunasta.	545395	545432	lehtonen1910a	4	37
Rosina on hyvillään.	518805	518825	lehtonen1910a	2	20
Rosina on ihan hiljaa.	99200	99222	lehtonen1910a	3	22
Rosina on kuin tuli ja leimaus.	100462	100493	lehtonen1910a	5	31
Rosina on melkeinpä lyhytkasvuinen.	45208	45243	lehtonen1910a	3	35
Rosina on menetellyt niinkuin on voinut.	464585	464625	lehtonen1910a	5	40
Rosina on noussut pystyyn.	102278	102304	lehtonen1910a	3	26
Rosina on saanut Esterin valmiiksi.	548003	548038	lehtonen1910a	4	35
Rosina on sekaantunut ja loukkaantunut.	279840	279879	lehtonen1910a	4	39
Rosina on suuttunut.	280240	280260	lehtonen1910a	2	20
Rosina on tullut takaisin sisään.	453993	454026	lehtonen1910a	4	33
Rosina pisti kiireesti uunin lämpiämään.	617627	617667	lehtonen1910a	4	40
Rosina rientää paraikaa ylös mökille.	613828	613865	lehtonen1910a	4	37
Rosina rupeaa jo myöntelemään.	558273	558303	lehtonen1910a	3	30
Rosina ryntää pihalle.	421129	421151	lehtonen1910a	2	22
Rosina säkättää Topille.	685331	685355	lehtonen1910a	2	24
Rosina se siellä huutaa.	628953	628977	lehtonen1910a	3	24
Rosina selittää vähän lisää.	746073	746101	lehtonen1910a	3	28
Rosina selitti sen likaantuvan.	546528	546559	lehtonen1910a	3	31
Rosina toi sen porsaan veneellä, säkissä.	337064	337105	lehtonen1910a	5	41
Rosina tulee saunasta.	755160	755182	lehtonen1910a	2	22
Rosina työnnäiksen tien tulpaksi.	500014	500047	lehtonen1910a	3	33
Rosina työntää Esterin päälle vanhaa mekkoa.	547375	547419	lehtonen1910a	5	44
Rosina vie hänet sisään.	756356	756380	lehtonen1910a	3	24
Rosinaa epäröittää.	278084	278103	lehtonen1910a	1	19
Rosinahan se oli.	675978	675995	lehtonen1910a	2	17
Rosinakaan ei heitä enää näe.	496303	496332	lehtonen1910a	4	29
Rosinalla on huolensa.	323844	323866	lehtonen1910a	2	22
Rosinalla on taikinanjuuri jo valmis happanemaan.	456514	456563	lehtonen1910a	5	49
Rosinalle itselleenkin se nyt tekee vahingon.	501552	501597	lehtonen1910a	5	45
Rosinan kieli laukeaa vähitellen.	557017	557050	lehtonen1910a	3	33
Rosinan mieli myrtyy Saaraa ajatellessa.	740401	740441	lehtonen1910a	4	40
Rosinan sydän on lämminnyt.	739361	739388	lehtonen1910a	3	27
Rosinan sydäntä ennättää parahiksi epäilyttämään.	273929	273978	lehtonen1910a	4	49
Roska silmässä.	3397	3412	jarnefelt1913a	1	15
Rouva aina vaan panee leikiksi.	99077	99108	canth1886a	4	31
Rouva Karell, mitä on tapahtunut?	195998	196031	canth1886a	4	33
Rovasti ja kappalainen tulivat sisälle.	81575	81614	jarnefelt1913a	4	39
Ruohikko tuoksuaa.	644324	644342	lehtonen1910a	1	18
Ruoho puiden juuressa on kaunista.	609392	609426	lehtonen1910a	4	34
Ruokasalin oven luona puhelin.	89946	89976	jarnefelt1913a	3	30
Ruotsimieliset pitävät puoliaan, se on luonnollista.	144695	144747	canth1886a	5	52
Rupeatko remmiin, vai et?	488687	488712	lehtonen1910a	3	25
Rupeatko?	489921	489930	lehtonen1910a	0	9
Rupeisiko ehkä sohvalle omassa huoneessaan?	133576	133619	canth1886a	4	43
Rupesimme juomaan teetä.	189561	189585	jarnefelt1916a	2	24
Rupesin lukemaan.	139457	139474	jarnefelt1916a	1	17
Rupesipa sopertamaan suomeakin.	44942	44973	jarnefelt1916a	2	31
Rusinansyöjän kanssa.	764041	764062	lehtonen1910a	1	21
Ruskeat kengät isoissa jaloissaan.	548464	548498	lehtonen1910a	3	34
Ruumis on kääntynyt uuniin päin.	331276	331308	lehtonen1910a	4	32
Ruumis värisi.	60876	60890	canth1886a	1	14
Rynkyttämällä ei vesi kaatuisi niin joutuisasti.	171392	171440	lehtonen1910a	5	48
Ryssä möi kaupungissa.	151051	151073	lehtonen1910a	2	22
Saa menne.	100493	100503	jarnefelt1913a	1	10
Saahan sitä niiden paperien nojalla.	229999	230035	lehtonen1910a	4	36
Saako olla?	95428	95439	jarnefelt1913a	1	11
Säälikin tuli Ihalaista.	82692	82716	lassila1910a	2	24
Saanko tarjota teetä?	106244	106265	jarnefelt1913a	2	21
Saara ei kuule.	254210	254225	lehtonen1910a	2	15
Saara huomauttaa, että päivän läätäminen päivetyttää.	180839	180892	lehtonen1910a	5	53
Saara ja Ananias purskahtavat nauruun.	147379	147417	lehtonen1910a	4	38
Saara jatkaa nurisemistaan.	139019	139046	lehtonen1910a	2	27
Saara kiertää vielä ahon yläreunaa myöten.	609165	609207	lehtonen1910a	5	42
Saara köntystää ohitse saunaan.	459201	459232	lehtonen1910a	3	31
Saara kuorsaa.	441087	441101	lehtonen1910a	1	14
Saara kuulee, mitä neiti puhuu raja-aidoista.	604233	604278	lehtonen1910a	5	45
Saara nauraa, iloisemmin kuin Rosina.	147919	147956	lehtonen1910a	4	37
Saara oli silloin tuvassa yksinään.	740539	740574	lehtonen1910a	4	35
Saara on innostunut kertomaan tervahöyrystä.	142755	142799	lehtonen1910a	4	44
Saara on noussut aivan äidin luokse.	255904	255940	lehtonen1910a	5	36
Saara pukeutuu kodan penkillä.	744426	744456	lehtonen1910a	3	30
Saara sanonut, että hän on leipäsusi.	495283	495320	lehtonen1910a	5	37
Saara se on.	608978	608990	lehtonen1910a	2	12
Saara teristää korviaan.	603732	603756	lehtonen1910a	2	24
Saara vaikenee hetkeksi.	138754	138778	lehtonen1910a	2	24
Saara vannoskeli puhuvansa totta.	622420	622453	lehtonen1910a	3	33
Saara, kuule, se on ruvettava työhön.	624365	624402	lehtonen1910a	5	37
Saaraa ei haluta heittää häränpyllyä.	643652	643689	lehtonen1910a	4	37
Saaralla on ne punaiset sukat.	132796	132826	lehtonen1910a	4	30
Saaran nappikengät, housunsuiden päälle vedetyt, kolisevat.	151930	151989	lehtonen1910a	5	59
Saaran päätä pakottaa.	454897	454919	lehtonen1910a	2	22
Saarankin ajaa moinen makuulta.	85184	85215	lehtonen1910a	3	31
Saaret ja niemet verhoutuvat siniseen autereeseen.	6259	6309	lehtonen1910a	5	50
Saarukka.	645005	645014	lehtonen1910a	0	9
Saattaa siitä asiasta vielä tulla tosikin.	135622	135664	lehtonen1910a	5	42
Saattaako semmoista kertoa edes Hiljalle?	87479	87520	jarnefelt1916a	4	41
Saattoihan mokoman edessä olla sitäkin.	63409	63448	jarnefelt1916a	4	39
Sadastiko teitä täytyy pökyyttää.	565758	565791	lehtonen1910a	3	33
Sahan hovilleko ja myllylle?	106413	106441	lehtonen1910a	3	28
Sairasvoimistelua.	6017	6035	jarnefelt1913a	0	18
Sairautta ja tautia, kurjuutta kaikenmoista.	81354	81398	canth1886a	4	44
Saisihan hän sen sitten tultuakin tietää.	47490	47531	lassila1910a	5	41
Saisiko olla filemoonia?	278258	278282	lehtonen1910a	2	24
Saisivat elinkaudeksi viedä.	185127	185155	lehtonen1910a	2	28
Säkki on vieressä kivellä.	381497	381523	lehtonen1910a	3	26
Säkkiin.	311310	311318	lehtonen1910a	0	8
Säksättäköön Pertta hänen takanaan, ja Rosinakin.	500340	500389	lehtonen1910a	5	49
Salin ikkunoista on otettu pois sanomalehtipaperit.	598135	598186	lehtonen1910a	5	51
Salin lattiaa ei vielä oltu pesty.	154608	154642	canth1886a	5	34
Salissa jatkettiin keskustelua tyynesti ja tasaisesti.	224961	225015	canth1886a	5	54
Sallittaisiinko heidän elää yhä Putkinotkossa?	739389	739435	lehtonen1910a	4	46
Sama kuoleman hiljaisuus.	52894	52919	jarnefelt1913a	2	25
Sama on Juutas ollut ikänsä.	52913	52941	lehtonen1910a	4	28
Sama on kuvernörin laita.	45806	45831	jarnefelt1913a	3	25
Samalla iski hän silmää Jussille.	147170	147203	lassila1910a	4	33
Samalla tavalla ravisteli Aapeli tässäkin itseään.	668563	668613	lehtonen1910a	5	50
Samanikäinen on heidän porsaansa kuin nämäkin.	337106	337152	lehtonen1910a	5	46
Samanne päinkin katsoivat aina.	101244	101275	lassila1910a	3	31
Samassa kavahti Mari istumaan.	38890	38920	canth1886a	3	30
Samassa kuulen kulkusten helinän pihalta.	254780	254821	jarnefelt1916a	4	41
Samassa Martti nousi seisaalleen.	286697	286730	jarnefelt1916a	3	33
Samassa tuli äiti sisään.	2867	2892	pakkala1895a	3	25
Samassa tulivat kaikki pojat ulos.	60533	60567	jarnefelt1913a	4	34
Samat olivat, eikä kuitenkaan samat.	194639	194675	canth1886a	4	36
Samoin Maunon, läävälle ja korsulle päin.	756222	756263	lehtonen1910a	5	41
Samoin tunteet ja ajatukset.	211386	211414	canth1886a	3	28
Sanelma ajaa Topia takaa.	227786	227811	lehtonen1910a	3	25
Sanelma antaa Jopille namusia.	555068	555098	lehtonen1910a	3	30
Sanelma ei tottele.	398922	398941	lehtonen1910a	2	19
Sanelma hymyilee hänelle, niinkuin aina muillekin.	634496	634546	lehtonen1910a	5	50
Sanelma hypähtelee ilosta.	554474	554500	lehtonen1910a	2	26
Sanelma innostuu.	220114	220131	lehtonen1910a	1	17
Sanelma itkee ja kiroilee.	535773	535799	lehtonen1910a	3	26
Sanelma ja Jopi juoksevat pihalle.	664584	664618	lehtonen1910a	4	34
Sanelma loikoo permannolla.	304548	304575	lehtonen1910a	2	27
Sanelma menee ovelle.	554813	554834	lehtonen1910a	2	21
Sanelma on komennettu sitä katsomaan.	224907	224944	lehtonen1910a	4	37
Sanelma on menossa alaveräjälle.	539318	539350	lehtonen1910a	3	32
Sanelma vilkaisee maahan, vilkkuu syrjään.	227069	227111	lehtonen1910a	4	42
Sanelman on annettava vielä hänellekin.	555434	555473	lehtonen1910a	4	39
Sanelman volina kuuluu kujalta.	540792	540823	lehtonen1910a	3	31
Sannako?	37788	37796	pakkala1895a	0	8
Sanoi apteekkari olevan sen haavoillekin.	568270	568311	lehtonen1910a	4	41
Sanoin ja istuin.	54002	54019	jarnefelt1913a	2	17
Sanoivatkin sitä Jumalankiveksi.	83481	83513	pakkala1895a	2	32
Sanoja ei tosin erota.	413259	413281	lehtonen1910a	3	22
Sanoo Esterinkin kantavansa, toisella käsivarrellaan.	757426	757479	lehtonen1910a	4	53
Sanovat Ruuna-Mikoksi.	753271	753293	lehtonen1910a	1	22
Sanukka juoksee alaveräjälle ja kiipeää pihalle.	743532	743580	lehtonen1910a	5	48
Sanukka, juokse hakemaan.	87049	87074	lehtonen1910a	2	25
Sarkkisen kartanolla leikkimajan ja tytöt siellä.	128104	128153	pakkala1895a	5	49
Sateenvarjot.	722365	722378	lehtonen1910a	0	13
Sattumoisin oli hän tänne joutunut.	797123	797158	lehtonen1910a	4	35
Sauna oli nyt pakahtua höyrystä.	41611	41643	lassila1910a	4	32
Sauna?	558763	558769	lehtonen1910a	0	6
Saunan nokisessa ikkunassa hämärtyy.	672860	672896	lehtonen1910a	3	36
Saunan ovi avautuu.	727533	727552	lehtonen1910a	2	19
Saunassa kohahti ja humisi parhaillaan löyly.	708830	708875	lehtonen1910a	5	45
Saunasta nousee hienoa höyryä.	627708	627738	lehtonen1910a	3	30
Savikylpyjä.	6047	6059	jarnefelt1913a	0	12
Savu ja höyry menevät ulos korsteenista.	309656	309696	lehtonen1910a	5	40
Se aikoo jo lähteä sinne juoksemaan.	14836	14872	lehtonen1910a	5	36
Se alkoi harmittaa.	68699	68718	jarnefelt1916a	2	19
Se antaa toivoa.	146927	146943	canth1886a	2	16
Se ei auta.	233451	233462	lehtonen1910a	2	11
Se ei kerro.	311243	311255	lehtonen1910a	2	12
Se ei tahtonut.	756919	756934	lehtonen1910a	2	15
Se ei tottele saunavastaakaan.	685835	685865	lehtonen1910a	3	30
Se haju tuntuu hänestä pahalta.	132435	132466	lehtonen1910a	4	31
Se häntä siinä on myrkkyä.	212193	212219	lehtonen1910a	4	26
Se herkeää hetkeksi.	405604	405624	lehtonen1910a	2	20
Se hjuuvä, se hjuuvä.	105545	105566	jarnefelt1913a	3	21
Se hyväksyttiin.	93180	93196	pakkala1895a	1	16
Se juoksee portaillekin itkemään.	756322	756355	lehtonen1910a	3	33
Se jutteli, mummo.	675140	675158	lehtonen1910a	2	18
Se jyskytys vahvenee.	762597	762618	lehtonen1910a	2	21
Se kääntyy lukossa aivan kevyesti.	2986	3020	jarnefelt1916a	4	34
Se katkeruus on kurkussa kuin suola.	60482	60518	lehtonen1910a	5	36
Se kelletti nyt maassa pitkällänsä.	291362	291397	lassila1910a	4	35
Se kiusasi Jussia.	19383	19401	lassila1910a	2	18
Se kohottaa pystykorviaan.	14873	14899	lehtonen1910a	2	26
Se komentelisi työhön.	409078	409100	lehtonen1910a	2	22
Se kun haisi.	183488	183501	lehtonen1910a	2	13
Se kun on sellainen.	692295	692315	lehtonen1910a	3	20
Se kuuluu jo sangen kauas.	421366	421392	lehtonen1910a	4	26
Se läähättää.	205102	205115	lehtonen1910a	1	13
Se lepäsi arkussaan havumajassa suruhuoneen vieressä.	65831	65884	pakkala1895a	5	53
Se lepikko painuu nyt iltapuolen siimekseen.	579902	579946	lehtonen1910a	5	44
Se menee kuin kanan suoli.	564076	564102	lehtonen1910a	4	26
Se murisee ja juoksee ympäri Repekan.	639898	639935	lehtonen1910a	5	37
Se mustaverinen mies, tiedäthän.	766498	766530	lehtonen1910a	3	32
Se myöskin sitä ryssää.	450990	451013	lehtonen1910a	3	23
Se nauru kuulostaa hiukan ilkeältä.	687707	687742	lehtonen1910a	4	35
Se niin keventää Rosinan sydäntä.	556691	556724	lehtonen1910a	4	33
Se nosti mullistuksen kukkuroilleen.	30495	30531	jarnefelt1913a	3	36
Se nykäisty on Topi.	124356	124376	lehtonen1910a	3	20
Se oli ainoa pelastuksemme.	130358	130385	jarnefelt1916a	3	27
Se oli hänen virkkua aikaansa.	94601	94631	lehtonen1910a	4	30
Se oli häväistys.	636913	636930	lehtonen1910a	2	17
Se oli jokin uusi mies.	81007	81030	jarnefelt1916a	4	23
Se oli kuin jokin uusi aurinko.	80594	80625	jarnefelt1916a	5	31
Se oli kuin luonnon riemuhuudahdus.	185946	185981	jarnefelt1916a	4	35
Se oli Martti.	62491	62505	jarnefelt1916a	2	14
Se oli se ensimmäinen syy.	333944	333970	lehtonen1910a	4	26
Se oli tietysti sulaa huolimattomuutta.	52963	53002	pakkala1895a	4	39
Se oli tulta tappuroihin.	3791	3816	pakkala1895a	3	25
Se oli vain lohdutukseksi minulle.	285235	285269	jarnefelt1916a	4	34
Se oli Vatasen ja Kaisan kulkue.	273223	273255	lassila1910a	5	32
Se oli vielä hiljaista.	419936	419959	lehtonen1910a	3	23
Se olisi tarpeeksi iso.	386185	386208	lehtonen1910a	3	23
Se on franska, lue, pikku.	94594	94620	jarnefelt1913a	4	26
Se on hän.	131129	131139	jarnefelt1913a	2	10
Se on heikon humaniteetin rajuluontoinen lapsi.	109406	109453	canth1886a	5	47
Se on heti mentävä hakemaan saunapuita.	565386	565425	lehtonen1910a	5	39
Se on hunajan hajua.	583384	583404	lehtonen1910a	3	20
Se on hyvä kuulla.	152996	153014	jarnefelt1913a	3	18
Se on ishias, sanon minä teille.	4948	4980	jarnefelt1913a	5	32
Se on jo ihme.	544078	544092	lehtonen1910a	3	14
Se on Jussi hyvä hevosmies.	29441	29468	lassila1910a	4	27
Se on Juutaksen auttaja.	505340	505364	lehtonen1910a	3	24
Se on Juutas Käkriäisen ääni.	703171	703200	lehtonen1910a	4	29
Se on käynyt täällä jauhonostossa.	349809	349843	lehtonen1910a	4	34
Se on kolmetoistahaarainen ase.	690175	690206	lehtonen1910a	3	31
Se on korkealla mäellä.	381570	381593	lehtonen1910a	3	23
Se on kuitenkin väleissämme mahdotonta.	206930	206969	jarnefelt1916a	4	39
Se on minu velvollisuus.	98131	98155	jarnefelt1913a	3	24
Se on naisten työtä.	296626	296646	lehtonen1910a	3	20
Se on niin surullista, etten siedä.	780353	780388	lehtonen1910a	5	35
Se on ollut jo melkein taipuvainen.	307647	307682	lehtonen1910a	5	35
Se on ollut varsin edullistakin Konstalle.	366266	366308	lehtonen1910a	5	42
Se on ruohonpäinen.	289993	290012	lehtonen1910a	2	19
Se on se keto.	94517	94531	pakkala1895a	3	14
Se on sellainen.	723484	723500	lehtonen1910a	2	16
Se on semmoinen.	520358	520374	lehtonen1910a	2	16
Se on tässä höyryytettävä.	565119	565145	lehtonen1910a	3	26
Se on totta, totta.	311586	311605	lehtonen1910a	3	19
Se on tulikoura, jota tuulastaessa tarvitaan.	688563	688608	lehtonen1910a	5	45
Se on tuolla tuvalla.	349095	349116	lehtonen1910a	3	21
Se on varma, että nyt syödään.	86170	86200	pakkala1895a	5	30
Se on virkkavala, Tyyne.	100969	100993	jarnefelt1913a	3	24
Se pitäisi olla häpeällistä miehelle.	98316	98353	jarnefelt1913a	4	37
Se puhkasi minut.	41164	41181	jarnefelt1913a	2	17
Se pussi on keltainen.	211946	211968	lehtonen1910a	3	22
Se pyrki siivilleen, ei heti päässytkään.	172907	172948	lehtonen1910a	5	41
Se rinne vie äskeistä jyrkännettä uhemmin.	381931	381973	lehtonen1910a	5	42
Se Rosinan vastaamattomuus saattaisikin lauhduttaa Käkriäisen.	91854	91916	lehtonen1910a	5	62
Se runteli minut.	41182	41199	jarnefelt1913a	2	17
Se sallii syödä säästelemättä itseään.	67379	67417	lehtonen1910a	4	38
Se sana ei riitä, rakas Hilja.	54260	54290	jarnefelt1916a	5	30
Se sätkytys oli kovennut.	545369	545394	lehtonen1910a	3	25
Se se oli kiskonutkin verkon pohjamutiin.	191850	191891	lehtonen1910a	5	41
Se se on villipeto.	501220	501239	lehtonen1910a	3	19
Se se vasta peto onkin.	501196	501219	lehtonen1910a	4	23
Se selkä ei koukistu, ei notku.	179200	179231	lehtonen1910a	5	31
Se sen tietää, tuo Juutas.	750216	750242	lehtonen1910a	4	26
Se tirkisteli seinän alitse rannalle.	417547	417584	lehtonen1910a	4	37
Se toitottaa kuin vaskitorvi.	689747	689776	lehtonen1910a	3	29
Se tuli niin äkkiä.	232689	232708	canth1886a	3	19
Se tuntui pakenevan.	59735	59755	lassila1910a	2	20
Se ura nousee rannan suurille kivilohkareille.	608647	608693	lehtonen1910a	5	46
Se vaikutti Maija Liisaan.	205376	205402	lassila1910a	3	26
Se vain hautui.	9772	9787	lassila1910a	2	15
Se vie niemen kärkeä pitkin.	609494	609522	lehtonen1910a	4	28
Se viiletti pelästyneenä puroon.	333050	333082	lehtonen1910a	3	32
Se vikisee, rähisee, ravistelee multaisia karvojaan.	393210	393262	lehtonen1910a	5	52
Se vitkastelee.	309195	309210	lehtonen1910a	1	15
Se voisi kompuroida paarmoissaan minne tahansa.	205811	205858	lehtonen1910a	5	47
Se yhtenään häilyy mielessäni.	121355	121385	canth1886a	3	30
Se yrittää silmille, kun sitä potkaisee.	385275	385315	lehtonen1910a	5	40
Sehän on Aapeli Muttisen huvila.	10787	10819	lehtonen1910a	4	32
Sehän on herra: kirjakauppias Muttinen.	528835	528874	lehtonen1910a	4	39
Sehän tarkoitti tuota vanhaa, tuttua.	188012	188049	jarnefelt1916a	4	37
Seipäät heiluivat ilmassa.	112056	112082	lassila1910a	2	26
Seisoi hetken seinänvieressä ja koetti tyyntyä.	23330	23377	canth1886a	5	47
Seisoin henkeäni pidätellen aidan takana.	61923	61964	jarnefelt1913a	4	41
Seitsemäs luku   Aurinko lämmittää.	58449	58484	lehtonen1910a	5	35
Sekä kirjoja.	598596	598609	lehtonen1910a	1	13
Sekä väsynyt Hurja.	403847	403866	lehtonen1910a	2	19
Sekin määiskelee.	689248	689265	lehtonen1910a	1	17
Sekin talo on varmaan torni.	260654	260682	lehtonen1910a	4	28
Selailee oikeanpuoleisella pöydällä olevaa postia.	94499	94549	jarnefelt1913a	4	50
Selässä?	4911	4919	jarnefelt1913a	0	8
Selässäni.	369035	369045	lehtonen1910a	0	10
Selkäpuolelta enemmän kuin harmaa.	212010	212044	lehtonen1910a	3	34
Sellainen hän on potattia viljelemään.	195387	195425	lehtonen1910a	4	38
Sellainen helle, että linnutkin ovat hiljaa.	378437	378481	lehtonen1910a	5	44
Sellainen houkuttelu oli itsekästä.	772644	772679	lehtonen1910a	3	35
Sellainen iso metso.	175103	175123	lehtonen1910a	2	20
Sellainen jumala vaan on, poppa, muka.	114368	114406	lehtonen1910a	5	38
Sellainen kiire oli herran kanssa riitelemään.	595871	595917	lehtonen1910a	5	46
Sellainen oli alku.	51134	51153	lehtonen1910a	2	19
Sellainen oli kotona ja kaikkialla.	105294	105329	pakkala1895a	4	35
Sellainen on ihminen.	324111	324132	lehtonen1910a	2	21
Sellainen on Jopi, Rosinan rotuun tullut.	259334	259375	lehtonen1910a	5	41
Sellainen on pohjolan kesä.	24865	24892	lehtonen1910a	3	27
Sellainen on Reisvänni.	291208	291231	lehtonen1910a	2	23
Sellainen on tämä laki.	691006	691029	lehtonen1910a	3	23
Sellainen pesä on Putkinotkosta vähitellen tullut.	762494	762544	lehtonen1910a	5	50
Sellainen se on, lupittaja.	52217	52244	lehtonen1910a	3	27
Sellainen torvi sillä akalla on kurkkuna.	413217	413258	lehtonen1910a	5	41
Sellainen tuo on ollut kesäkin.	95582	95613	lehtonen1910a	4	31
Sellaisella tuulella hän on tänä päivänä.	201640	201681	lehtonen1910a	5	41
Sellaisia ilkeitä ovat nämä urosporsaat.	42540	42580	lehtonen1910a	4	40
Sellaisia ne ovat Malakiaksen virret.	316296	316333	lehtonen1910a	4	37
Sellaisia tämän kylän ihmiset ovat.	291814	291849	lehtonen1910a	4	35
Sellaisiahan ovat ihmiset aina.	324133	324164	lehtonen1910a	3	31
Sellaisiako heistä tuleekin, huonoja ja köntyksiä?	56290	56340	lehtonen1910a	5	50
Sellaista hevosen leikkiä.	509014	509040	lehtonen1910a	2	26
Sellaista katselua ei Juutas siedä.	497645	497680	lehtonen1910a	4	35
Sellaista kuin kasku tarinoi.	502101	502130	lehtonen1910a	3	29
Sellaisten perästä hän toki juoksee.	172995	173031	lehtonen1910a	4	36
Semmoinen ihminen on mahdoton.	173436	173466	jarnefelt1916a	3	30
Semmoiselta se toisistakin tuntui.	9807	9841	pakkala1895a	3	34
Semmoista hirmuisen lapsellista.	119667	119699	canth1886a	2	32
Sen ajattelun johdosta vaiettiin hetkinen.	19875	19917	lassila1910a	4	42
Sen hän kiljaisee kimeästi.	423093	423120	lehtonen1910a	3	27
Sen huomasi Anna Liisakin.	95449	95475	lassila1910a	3	26
Sen iltapäivää Anni nukkui jotenkin levollisesti.	49065	49114	canth1886a	5	49
Sen jälkeen tulevat he ulos jyrkänteelle.	799189	799230	lehtonen1910a	5	41
Sen juurella on kumpu, perunakuoppa.	8422	8458	lehtonen1910a	4	36
Sen kyllä Käkriäinen tietää.	340753	340781	lehtonen1910a	3	28
Sen luokse ei ole pitkälti matkaa.	383576	383610	lehtonen1910a	5	34
Sen näkee Topi.	124912	124927	lehtonen1910a	2	15
Sen olen huomannut.	776249	776268	lehtonen1910a	2	19
Sen pahemmitta selvisivät siitä.	108984	109016	lassila1910a	3	32
Sen saa auki, kun sorkottelee varvulla.	133659	133698	lehtonen1910a	5	39
Sen sanoo hän hiukan pilkallisesti.	141930	141965	lehtonen1910a	4	35
Sen sijaan tapasin Jöijen.	52530	52556	jarnefelt1916a	3	26
Sen sisällä näytti olevan hauska olla.	120645	120683	pakkala1895a	5	38
Sen tiesi äiti ja Vappu etukäteen.	53339	53373	pakkala1895a	5	34
Sen verran oli Käkriäisen itsetunto loukkautunut.	351799	351848	lehtonen1910a	5	49
Sentähden en tappanut itseäni.	65700	65730	jarnefelt1913a	3	30
Sepä sattui hyvin.	99084	99102	jarnefelt1913a	2	18
Seppeleet ylimpänä näyttävät tarpeettomilta, tummilta pyörylöiltä.	158061	158127	jarnefelt1916a	5	66
Seteleitä niinkuin allakanlehtiä.	94665	94698	lehtonen1910a	2	33
Seuraa saunotus.	697142	697158	lehtonen1910a	1	16
Seuraavan kuorman päällä loikoi Antti mahallaan.	273377	273425	lassila1910a	5	48
Seuraavana päivänä ilmestyi poliseja kouluun.	62162	62207	jarnefelt1913a	4	45
Seuraavat päivät hän sitä vaan ajatteli.	156100	156140	canth1886a	5	40
Seurustelemasta lihavien unien ja kirjojensa parissa.	586407	586460	lehtonen1910a	5	53
Sian näköinen se tohtori on.	361450	361478	lehtonen1910a	4	28
Siellä hän sitten jälleen seisoo.	614173	614206	lehtonen1910a	4	33
Siellä haukkuu Hurja, salo kaikuu.	235986	236020	lehtonen1910a	4	34
Siellä istui rouva Leistén sohvalla.	190283	190319	canth1886a	4	36
Siellä istuu Topi isolla kivellä kujalla.	76706	76747	lehtonen1910a	5	41
Siellä kävi hän toissa talvena.	127521	127552	lehtonen1910a	4	31
Siellä ne Käkriäisten lehmät lienevät.	633329	633367	lehtonen1910a	4	38
Siellä oli hiljaista, hämärätä.	153029	153060	canth1886a	3	31
Siellä oli Saarakin kahvin ryöpsähtäessä hellalle.	594116	594166	lehtonen1910a	5	50
Siellä olisi hänen hauska olla.	75282	75313	pakkala1895a	4	31
Siellä on joukossa jos jotain, perhana.	492099	492138	lehtonen1910a	5	39
Siellä pikku Sanelma tuudittaa Luukasta.	680089	680129	lehtonen1910a	4	40
Siellä Repekka inttää Lejalta lilliä.	749381	749418	lehtonen1910a	4	37
Siellä se Juutas nyt istua notkottaa.	388449	388486	lehtonen1910a	5	37
Siellä se on vielä, se metsäsika.	393351	393384	lehtonen1910a	5	33
Siellä vedättää Ananias heiniä.	613722	613753	lehtonen1910a	3	31
Sielläkö sinä olet, minun ryssäni?	597084	597118	lehtonen1910a	4	34
Sielläpä näkeekin hän isänsä tulevan.	362868	362905	lehtonen1910a	4	37
Sieltä on annettu ennenkin velaksi.	96711	96746	lehtonen1910a	4	35
Sieltä päin on mummo tullut, kiertoteitä.	318430	318471	lehtonen1910a	5	41
Sieltä päin ruskotti omituinen puna.	177388	177424	jarnefelt1916a	4	36
Sieltä sattui käteen täysi viinalekkeri.	70910	70950	lassila1910a	4	40
Sieltä tulikin vain isä.	81546	81570	pakkala1895a	3	24
Sieltähän ne akat sanovat lapsia löytävänsä.	657997	658041	lehtonen1910a	5	44
Sienet, ja puolukat marjoista.	149816	149846	lehtonen1910a	3	30
Sievän Ananiaksen korvatkin ovat hiukan punaiset.	445469	445518	lehtonen1910a	5	49
Sihtasi huuhkajaa tuonne puuhun.	789854	789886	lehtonen1910a	3	32
Siihen aikaan sai lainata siltä kaikkea.	134044	134084	lehtonen1910a	5	40
Siihen asettuu Hurjakin leppien varjoon.	229317	229357	lehtonen1910a	4	40
Siihen ei Käkriäinen nyt tahtoisi koskettaa.	750484	750528	lehtonen1910a	5	44
Siihen hän istahtaa.	657390	657410	lehtonen1910a	2	20
Siihen jätti hän sammion toistaiseksi.	734533	734571	lehtonen1910a	4	38
Siihen meni koko kaupunkilaisuus.	64251	64284	jarnefelt1916a	3	33
Siihen pysähtykäämme.	45514	45535	jarnefelt1913a	1	21
Siihen se mätänee.	63208	63226	lehtonen1910a	2	18
Siihen se seisahtuu, housuntakapuolet pussillaan.	201157	201206	lehtonen1910a	4	49
Siihen se tappaminen jää.	497681	497706	lehtonen1910a	3	25
Siinä aidalla hän sitten levähtää.	379590	379624	lehtonen1910a	4	34
Siinä alkaa hän vähitellen hyräilläkin.	175763	175802	lehtonen1910a	4	39
Siinä ei ollut mitään sellaista.	87790	87822	jarnefelt1916a	4	32
Siinä ensimmäinen ehto terveelle, kansalliselle kehityksellemme.	186558	186622	canth1886a	5	64
Siinä hän huutelee Moksia.	197553	197579	lehtonen1910a	3	26
Siinä hän kyykähti hiukan lepäämään.	335596	335632	lehtonen1910a	4	36
Siinä hän makasi koko yön.	193068	193094	canth1886a	4	26
Siinä hän on.	185179	185192	jarnefelt1916a	2	13
Siinä hän pysähtyy ja katselee tupaan.	543237	543275	lehtonen1910a	5	38
Siinä hän sitten lepää.	381299	381322	lehtonen1910a	3	23
Siinä hän yökkäisee.	537073	537093	lehtonen1910a	2	20
Siinä he seisovat hetken.	612820	612845	lehtonen1910a	3	25
Siinä höläkkä oli.	213759	213777	canth1886a	2	18
Siinä istui lokki, paksunokkainen ja valkea.	533507	533551	lehtonen1910a	5	44
Siinä joukossa on neitikin.	721771	721798	lehtonen1910a	3	27
Siinä kirjava nauha.	548443	548463	lehtonen1910a	2	20
Siinä menisi viikko tai kaksi.	307497	307527	lehtonen1910a	4	30
Siinä ne harrottavat mustina ja kuivina.	581495	581535	lehtonen1910a	5	40
Siinä nyt ei mitään.	184533	184553	lehtonen1910a	3	20
Siinä nyt hänen mielestään oli paljon.	33343	33381	pakkala1895a	5	38
Siinä nyt yhtenä sorkkaläjänä survovat.	123695	123734	lehtonen1910a	4	39
Siinä oli kolme papua.	33096	33118	pakkala1895a	3	22
Siinä oli vehnäsiä ja pipernikkoja, joutavia.	449711	449756	lehtonen1910a	5	45
Siinä oma sänky, rautainen ja kultakoristeinen.	107274	107321	pakkala1895a	5	47
Siinä on juoksua.	401783	401800	lehtonen1910a	2	17
Siinä on nyt Mesopotamia aivan ympärillä.	287396	287437	lehtonen1910a	5	41
Siinä on päänalusena kylvetty saunavasta.	20196	20237	lehtonen1910a	4	41
Siinä ovat pojat äsken hakanneet saunapuita.	651118	651162	lehtonen1910a	5	44
Siinä pistää hän tupakkaakin piippuunsa.	207107	207147	lehtonen1910a	4	40
Siinä repeää takki kainalosta.	383946	383976	lehtonen1910a	3	30
Siinä samassa etehisen kelloa soitettiin.	170081	170122	canth1886a	4	41
Siinä se on laulanut aamuvirttänsä.	39773	39808	lehtonen1910a	4	35
Siinä se on se kana.	385413	385433	lehtonen1910a	4	20
Siinä se pankolta hävisi kuin lentämällä.	26275	26316	lehtonen1910a	5	41
Siinä se seisoo kumarassa, pitkine partoineen.	598744	598790	lehtonen1910a	5	46
Siinä sitä oltiin.	26575	26593	jarnefelt1913a	2	18
Siinä sopisi hänen nyt levähtää.	377511	377543	lehtonen1910a	4	32
Siinä tämä nyt on koko asia.	357261	357289	lehtonen1910a	5	28
Siinä täytyy hänen kätellä Ripattia.	344210	344246	lehtonen1910a	4	36
Siinä välillä vilkaisee Rosina pihalle.	541289	541328	lehtonen1910a	4	39
Siinä voi olla leikki kaukana.	43458	43488	jarnefelt1916a	4	30
Siinäpä se.	336850	336861	lehtonen1910a	1	11
Siis on tupaa ruvettu korjaamaan.	543507	543540	lehtonen1910a	4	33
Siitä ei hän nyt jätkähdäkään.	361042	361072	lehtonen1910a	4	30
Siitä hameen huiskauksesta kana suuttuu.	39900	39940	lehtonen1910a	4	40
Siitä hän ei piittaa.	384446	384467	lehtonen1910a	3	21
Siitä hauskasta kävelystä ne vain haastelevat.	604744	604790	lehtonen1910a	5	46
Siitä hetkestä saakka he sinuttelivat toisiansa.	85879	85927	jarnefelt1916a	5	48
Siitä jatkuvat ne kahtiajakautuneena vakona vatsalle.	89642	89695	lehtonen1910a	5	53
Siitä johtui taas mieleen toisia ajatuksia.	120905	120948	lassila1910a	5	43
Siitä lienee yhdeksänkin vuotta.	758734	758766	lehtonen1910a	3	32
Siitä näkyy lammen niitylle.	200673	200701	lehtonen1910a	3	28
Siitä oli remmi katkennut.	205972	205998	canth1886a	3	26
Siitä olivat he nyt niin toimessa.	22956	22990	pakkala1895a	5	34
Siitä se tulee.	193752	193767	canth1886a	2	15
Siitä se tuli sitten hänen rouvansa.	589316	589352	lehtonen1910a	5	36
Siitä tunsi hän lohdutusta.	33651	33678	pakkala1895a	3	27
Siitä ukosta tuli.	507104	507122	lehtonen1910a	2	18
Siitä voisi tulla.	114692	114710	lehtonen1910a	2	18
Siitäkin äkäisellä tavalla kielsivät.	29055	29092	pakkala1895a	3	37
Sika täällä on, iso sika.	578159	578184	lehtonen1910a	4	25
Sika urahtelee tallissa tyytyväisenä itsekseen.	473286	473333	lehtonen1910a	4	47
Sikeässä ne nukkuivat kaikki.	123793	123822	canth1886a	3	29
Siksi hän sitä asiaa tunnusteli.	549244	549276	lehtonen1910a	4	32
Siksi jää täällä leivättä.	323796	323822	lehtonen1910a	3	26
Siksi jääköönkin se yrittämättä.	223674	223706	lassila1910a	3	32
Siksi riita.	93682	93694	lehtonen1910a	1	12
Siksi Rosina tervehtii Vaskilahden emäntää.	246284	246327	lehtonen1910a	4	43
Siksi tahtoisi Rosina olla kiihtymättä.	91652	91691	lehtonen1910a	4	39
Siksipä se niin hyvälle nyt maistui.	12914	12950	canth1886a	5	36
Sillä aikaa laski Partanen edelleen.	210671	210707	lassila1910a	4	36
Sillä ei niitä ole vedetty.	550863	550890	lehtonen1910a	4	27
Sillä hän oli minulle Suomen kansa.	78085	78120	jarnefelt1913a	5	35
Sillä hän tiesi olevansa syytön mihinkään.	195062	195104	lassila1910a	5	42
Sillä hän uhkasi lyödä tulijaa.	81494	81525	pakkala1895a	4	31
Sillä he olivat köyhiä.	105928	105951	pakkala1895a	3	23
Sillä heillä oli niin hauskaa kahdenkesken.	166894	166937	canth1886a	5	43
Sillä Hurja on ajatellut sellaisen syömistäkin.	15569	15616	lehtonen1910a	5	47
Sillä ilta alkaa jo olla myöhä.	730277	730308	lehtonen1910a	5	31
Sillä kahvia minulla on aina.	303258	303287	lehtonen1910a	4	29
Sillä kaupunkiin hän on tänään lähdössä.	32776	32816	lehtonen1910a	5	40
Sillä Malakias ei juokse melkein koskaan.	168166	168207	lehtonen1910a	5	41
Sillä minä en lähtisikään niin vain.	185090	185126	lehtonen1910a	5	36
Sillä mitäs siinä olisi ihmettelemistä.	128164	128203	lehtonen1910a	4	39
Sillä muuten ei niistä pääse.	334778	334807	lehtonen1910a	4	29
Sillä neidillä se on valta Muttiseen.	549072	549109	lehtonen1910a	5	37
Sillä niin tyytyväinen olen nyt Putkinotkoon.	764532	764577	lehtonen1910a	5	45
Sillä nyt olisi puhuttava siitä.	274255	274287	lehtonen1910a	4	32
Sillä oli vähän niinkuin jalkoja.	715367	715400	lehtonen1910a	4	33
Sillä tavalla se hymyili vastaukseksi.	562560	562598	lehtonen1910a	4	38
Sillä tavoin se yhden kerran teki.	387751	387785	lehtonen1910a	5	34
Silläkin hakumatkalla viipyi hevosineen viikon.	51334	51381	lehtonen1910a	4	47
Silläkin tavoin Käkriäisen Juutasta vainotaan.	501128	501174	lehtonen1910a	4	46
Silloin alkaa Esterkin hiljaa anella.	517492	517529	lehtonen1910a	4	37
Silloin antaa Topi sen Saaralle.	572994	573026	lehtonen1910a	4	32
Silloin ehtii mummo ennen Rosinaa.	99279	99313	lehtonen1910a	4	34
Silloin hän mörisee.	157306	157326	lehtonen1910a	2	20
Silloin hätääntyy Repekka.	120517	120543	lehtonen1910a	2	26
Silloin huomasi Malakias Topin härnäämässä pässiä.	78057	78107	lehtonen1910a	5	50
Silloin innostuu Juutaskin sitä kaivelemaan.	392818	392862	lehtonen1910a	4	44
Silloin jää murtui.	132259	132278	jarnefelt1913a	2	19
Silloin John nousi ja läksi pois.	131089	131122	canth1886a	5	33
Silloin kiivastuu Jopi.	120966	120989	lehtonen1910a	2	23
Silloin kuvaisin varmaankin myrskyn lähestymistä.	9441	9490	jarnefelt1916a	4	49
Silloin kysyi Ihalainen.	55992	56016	lassila1910a	2	24
Silloin Lyygia itkisi.	600744	600766	lehtonen1910a	2	22
Silloin Martti sulki hänet syliinsä.	194150	194186	jarnefelt1916a	4	36
Silloin minä sanoin.	106229	106249	jarnefelt1916a	2	20
Silloin näin.	306568	306581	lehtonen1910a	1	13
Silloin närkästyi mahtava herrakin.	775533	775568	lehtonen1910a	3	35
Silloin niille pitäisi kaikki tehdä.	669486	669522	lehtonen1910a	4	36
Silloin ohjat äkkiä kiristyvät.	129594	129625	jarnefelt1913a	3	31
Silloin oli jo Muttinen saunan nurkkamalla.	546560	546603	lehtonen1910a	5	43
Silloin olisi hän rauhallisempi.	544475	544507	lehtonen1910a	3	32
Silloin olisi laiva jo mennyt ohitse.	154794	154831	lehtonen1910a	5	37
Silloin olit itkenyt, näin sen silmistäsi.	119155	119197	canth1886a	5	42
Silloin pääsee tuskasta vapaaksi.	224740	224773	canth1886a	3	33
Silloin rupeaa koskemaan pään sisään.	503512	503549	lehtonen1910a	4	37
Silloin Saara kääntyy.	254278	254300	lehtonen1910a	2	22
Silloin sattui Nymark tulemaan juuri pahimmoilleen.	154943	154994	canth1886a	5	51
Silloin se haihtuu saunasta.	693835	693863	lehtonen1910a	3	28
Silloin se olisi heille mieleinen.	301817	301851	lehtonen1910a	4	34
Silloin se tehdä riuhtoisi ehkä.	307366	307398	lehtonen1910a	4	32
Silloin suuttuu hän kovasti.	383151	383179	lehtonen1910a	3	28
Silloin syntyi äänettömyys.	255108	255135	lassila1910a	2	27
Silloin vilkastuu pikku Sanelmakin.	630167	630202	lehtonen1910a	3	35
Silloin, mitäs minä: raapaisin tulta.	212947	212984	lehtonen1910a	4	37
Silloinhan päättyi urakkani: mokomakin urakka.	780661	780707	lehtonen1910a	4	46
Silmänsä seuraavat jokaisen jäsenen joustavaa muotoa.	10166	10219	kilpi1903a	5	53
Silmät aukenevat pyöreiksi.	45923	45950	lehtonen1910a	2	27
Silmät kipenöivät.	496741	496759	lehtonen1910a	1	18
Silmät olivat ummessa, kasvot levolliset.	133205	133246	canth1886a	4	41
Silmät välkähtelevät koloistaan vihertävinä.	384572	384616	lehtonen1910a	3	44
Silmiä häikäisee aurinko.	229507	229532	lehtonen1910a	2	25
Silmistä valui vesi tulvana poskia pitkin.	90141	90183	canth1886a	5	42
Simpleksiä?	279615	279626	lehtonen1910a	0	11
Sinä annat jauhot ensimmäiseen keittoon.	486968	487008	lehtonen1910a	4	40
Sinä häntä lyömään.	160347	160366	lehtonen1910a	2	19
Sinä iltana istui John huolestuneena kamarissaan.	185058	185107	canth1886a	5	49
Sinä kannat vettä.	591369	591387	lehtonen1910a	2	18
Sinä, Saara.	645158	645170	lehtonen1910a	1	12
Sinikanteleen vaimo tulee tupaan, mustissa pyhävaatteissaan.	426743	426803	lehtonen1910a	5	60
Sininen savu täyttää kylyn.	657550	657577	lehtonen1910a	3	27
Sininen taivas kaareutuu Putkinotkon ylitse.	469650	469694	lehtonen1910a	4	44
Sinne asettuu Hurja huokaisten.	16186	16217	lehtonen1910a	3	31
Sinne järjestettiin kaikki niinkuin olla piti.	65669	65715	pakkala1895a	5	46
Sinne juoksee Hurjakin.	206318	206341	lehtonen1910a	2	23
Sinne nyt polku painuu.	612423	612446	lehtonen1910a	3	23
Sinne on tullut Topi Malakiaksen toveriksi.	473625	473668	lehtonen1910a	5	43
Sinne paistoi huvilan kuisti kelluvine lyhtyineen.	794119	794169	lehtonen1910a	5	50
Sinne rakoon Jopi nyt tunkeutuu.	262566	262598	lehtonen1910a	4	32
Sinne tekisi hänen mielensä kulkea.	110600	110635	lehtonen1910a	4	35
Sinne tuli nyt Tepon Iikkakin.	76031	76061	pakkala1895a	4	30
Sinnehän on virstojen matka.	368472	368500	lehtonen1910a	3	28
Sinun huoneesesi?	223833	223850	canth1886a	1	17
Sirkat sirisevät helteessä.	325917	325944	lehtonen1910a	2	27
Sirkat sirittävät eteläisemmän päädyn kohdalla koivuissa.	585186	585243	lehtonen1910a	5	57
Sirkka kilkuttaa mustan kiukaan takana.	658858	658897	lehtonen1910a	4	39
Sirujen kerääminen tuli Jussin yksinomaiseksi oikeudeksi.	28934	28991	pakkala1895a	5	57
Sisällä olivat todistajatkin.	234473	234502	lassila1910a	2	29
Sitä ajatusta en voinut kestää.	49282	49313	jarnefelt1916a	4	31
Sitä ei mies kuitenkaan ajattele.	106739	106772	lehtonen1910a	4	33
Sitä en ymmärrä ollenkaan.	102303	102329	jarnefelt1913a	3	26
Sitä hän ei vielä tullut ajatelleeksikaan.	23778	23820	canth1886a	5	42
Sitä he nyt kaikki tarkastavat.	798772	798803	lehtonen1910a	4	31
Sitä huhua he kaksi levittelivätkin.	588279	588315	lehtonen1910a	4	36
Sitä koskee tuo paperikin, jonka kyhäsin.	767168	767209	lehtonen1910a	5	41
Sitä myöten Rosinan onkin mentävä.	282398	282432	lehtonen1910a	4	34
Sitä myöten selvisi asia vähitellen.	237675	237711	lassila1910a	4	36
Sitä pisaraako?	40943	40958	jarnefelt1913a	1	15
Sitä pitää työntää, tyrkäistä.	188568	188598	lehtonen1910a	3	30
Sitä saatte.	280504	280516	lehtonen1910a	1	12
Sitä se jaksaa puuhata.	75714	75737	lehtonen1910a	3	23
Sitä sitten lauletaan yhteen tahtiin.	683137	683174	lehtonen1910a	4	37
Sitä tahtoikin Käkriäinen sanoa, ensinnäkin sitä.	148403	148452	lehtonen1910a	5	49
Sitä täytyi hänen nyt pysähtyä katsomaan.	338819	338860	lehtonen1910a	5	41
Sitä tehdessä meni puoli päivää.	258409	258441	lassila1910a	4	32
Sitä tiedustelee kauppaneuvos Juutakselta.	368501	368543	lehtonen1910a	3	42
Sitä varten on Mauno tänne otettu.	636140	636174	lehtonen1910a	5	34
Sitäkös nauravat Jopi ja pikku Ester.	681821	681858	lehtonen1910a	5	37
Siten istuu hän keskellä kirpeää savupilveä.	112355	112399	lehtonen1910a	5	44
Siten kulkevat he jälleen.	610064	610090	lehtonen1910a	3	26
Siten nukutaan Putkinotkon kesäisellä pihalla.	468626	468672	lehtonen1910a	4	46
Siten tarinoi Käkriäinen keittiössä varsin kauan.	358170	358219	lehtonen1910a	5	49
Siten tulee hän Putkinotkon lammen niitylle.	384669	384713	lehtonen1910a	5	44
Siten tuli sian hinta korvatuksi.	294373	294406	lassila1910a	4	33
Sitenhän houkuttelin heidät vetämään multia kukilleni.	777678	777732	lehtonen1910a	5	54
Sitte alkoi hän taas hakata leipoa.	288854	288889	lassila1910a	5	35
Sitten ajoivat he taas ääneti.	16965	16995	lassila1910a	4	30
Sitten alkaa Aapeli kylpeä uudestaan.	720196	720233	lehtonen1910a	4	37
Sitten alkaa Käkriäinen jälleen niittää.	634856	634896	lehtonen1910a	4	40
Sitten asettui Käkriäinen kahville pöydän ääreen.	447046	447095	lehtonen1910a	5	49
Sitten astuvat he jälleen veneeseen.	796168	796204	lehtonen1910a	4	36
Sitten avautui eteen mökin lahti.	533731	533764	lehtonen1910a	4	33
Sitten ei hän taas puhu tuokioon.	713333	713366	lehtonen1910a	5	33
Sitten hän heilutteli Tyysää polvellaan.	127844	127884	canth1886a	4	40
Sitten hän istahtaa kätkyen tyhjälle jalakselle.	682440	682488	lehtonen1910a	5	48
Sitten hän istui sohvallaan yhtä hiljaisena.	222179	222223	canth1886a	5	44
Sitten hän kääntyi Almaan.	210268	210294	canth1886a	3	26
Sitten hän kylvettää itseään.	715507	715536	lehtonen1910a	3	29
Sitten hän menee tosiaan läävän kujaan.	391400	391439	lehtonen1910a	5	39
Sitten hän meni noutamaan kerppuja.	734208	734243	lehtonen1910a	4	35
Sitten hän nyökyttää päätänsä, puraisee hampaitaan.	488497	488548	lehtonen1910a	5	51
Sitten hän rupeaa Ananiasta anelemaan.	233412	233450	lehtonen1910a	4	38
Sitten hän taas ojentautuu pystympään.	373803	373841	lehtonen1910a	4	38
Sitten hän vaikenee silmänräpäykseksi.	85948	85986	lehtonen1910a	3	38
Sitten hän yrittää sotkea asiaa.	454173	454205	lehtonen1910a	4	32
Sitten hänen silmänsä vettyivät.	61794	61826	pakkala1895a	3	32
Sitten he kulkevat edelleen.	407030	407058	lehtonen1910a	3	28
Sitten he onkivat, kaikki neljä.	615302	615334	lehtonen1910a	4	32
Sitten hevonen kiinni.	385453	385475	lehtonen1910a	2	22
Sitten huudetaan karjapihalla Malakiasta.	456611	456652	lehtonen1910a	3	41
Sitten iso Sanelma naurahtelee.	473413	473444	lehtonen1910a	3	31
Sitten istahtaa herra penkille.	552210	552241	lehtonen1910a	3	31
Sitten jatkaa hän esteetöntä kulkuaan kotiin.	384066	384111	lehtonen1910a	5	45
Sitten John läksi.	229544	229562	canth1886a	2	18
Sitten Jopi pesi oikein silmänsäkin.	130846	130882	lehtonen1910a	4	36
Sitten juovat he kahvia.	606286	606310	lehtonen1910a	3	24
Sitten jutellaan kaikenlaista.	312558	312588	lehtonen1910a	2	30
Sitten juttelee Mauno Ananiakselle jotain hiljaa.	647835	647884	lehtonen1910a	5	49
Sitten kallistaa hän Rosinaa kohti päänsä.	276559	276601	lehtonen1910a	5	42
Sitten kättelee Maunon Pertta Muttisen neitiä.	548701	548747	lehtonen1910a	5	46
Sitten kilistelevät pikku lapset lanttejaan.	651894	651938	lehtonen1910a	4	44
Sitten kulkee Rosina lehmiensä ohitse.	731766	731804	lehtonen1910a	4	38
Sitten kuuluu lasten ääniä ulkoa.	663536	663569	lehtonen1910a	4	33
Sitten kylvetään.	717615	717632	lehtonen1910a	1	17
Sitten lähtee Juutas pihalle.	386965	386994	lehtonen1910a	3	29
Sitten lapset taas syövät.	131574	131600	lehtonen1910a	3	26
Sitten löntystää Mauno hiljalleen tupaan.	542781	542822	lehtonen1910a	4	41
Sitten lyö Malakias oikeaa löylyä.	701479	701513	lehtonen1910a	4	34
Sitten menee Juutas riihelle.	201683	201712	lehtonen1910a	3	29
Sitten menee mummo risuineen tupaan.	326778	326814	lehtonen1910a	4	36
Sitten ne silmät kirkastuvat.	521390	521419	lehtonen1910a	3	29
Sitten otti parisen askelta.	75887	75915	lehtonen1910a	3	28
Sitten painui hän jälleen vuoteelle.	231174	231210	canth1886a	4	36
Sitten pallosiksi erottuivat.	41830	41859	jarnefelt1913a	2	29
Sitten pistäytyy Juutas saunaan, vaatteissaan.	703317	703363	lehtonen1910a	4	46
Sitten pujotti hän haukensa vitsaan.	193778	193814	lehtonen1910a	4	36
Sitten pysähdytään niittäjien luona.	373336	373372	lehtonen1910a	3	36
Sitten pysähtyy kauppaneuvos ensimmäisten haasiaintekijäin luokse.	372163	372229	lehtonen1910a	5	66
Sitten ryntää hän pihalle.	104284	104310	lehtonen1910a	3	26
Sitten Saara kertoo kaikenlaista.	456138	456171	lehtonen1910a	3	33
Sitten se ammuu kumeasti.	689834	689859	lehtonen1910a	3	25
Sitten se näkee, ettei siitäkään välitetä.	15964	16006	lehtonen1910a	5	42
Sitten se nousi kontrahtipaperin nojalla.	773937	773978	lehtonen1910a	4	41
Sitten se oli päässyt lehahtamaan karkuun.	722436	722478	lehtonen1910a	5	42
Sitten selittää Malakias, että metsohan se.	217183	217226	lehtonen1910a	5	43
Sitten taas ikäänkuin torkuttiin.	229722	229755	lassila1910a	3	33
Sitten tulee hiljaisuus.	439655	439679	lehtonen1910a	2	24
Sitten tulee Pertta pihalle Lyygian luo.	696247	696287	lehtonen1910a	5	40
Sitten tulee pitkä ja kaita katu.	282364	282397	lehtonen1910a	5	33
Sitten turvautuisi Jopi äitiin.	261958	261989	lehtonen1910a	3	31
Sitten vaiettiin.	221374	221391	lassila1910a	1	17
Sittenkin seisoi hän uhkaavana ja jäykkänä.	72645	72688	pakkala1895a	5	43
Sittenkin teki vielä mieli ottaa.	87351	87384	pakkala1895a	4	33
Sittenpä saat, minkä olet ansainnut.	18924	18960	pakkala1895a	4	36
Skandalen kan ej undvikas.	102718	102744	jarnefelt1913a	3	26
Söi matorohdot paljaaltaan.	442811	442838	lehtonen1910a	2	27
Soitimme kolmannen tohtorin.	70747	70775	jarnefelt1913a	2	28
Söivät illallista, puhelivat iloisesti ja nauroivat.	166641	166693	canth1886a	5	52
Solakka se oli.	297418	297433	lehtonen1910a	2	15
Soleita koivuja harvassa.	181283	181308	lehtonen1910a	2	25
Sortuu tuolille kuin salaman lyömänä.	101889	101926	jarnefelt1913a	4	37
Sotkuinen tukka huiskaa pään ympärillä.	158428	158467	lehtonen1910a	4	39
Soutaa syömään.	285280	285295	lehtonen1910a	1	15
Soutelevat korkean ja jyrkän vuoren juurella.	796205	796250	lehtonen1910a	5	45
Soutelevat sen kanssa.	248782	248804	lehtonen1910a	2	22
Sovinto oli nyt lopullinen.	294219	294246	lassila1910a	3	27
Sporttia?	124328	124337	canth1886a	0	9
Stiiknafuulia?	9177	9191	pakkala1895a	0	14
Sudenkorennot lentelevät hopeisin siivin.	624808	624849	lehtonen1910a	3	41
Sukkapuikot käyvät vinhaan, hiljaa kilisevät.	2697	2742	jarnefelt1913a	4	45
Suloiset syrjässä eläjät.	786675	786700	lehtonen1910a	2	25
Sulouden aalto koko olentoa valumassa?	72976	73014	kilpi1903a	4	38
Suokaa anteeksi, herra Leontjev.	106211	106243	jarnefelt1913a	3	32
Suokurppa on lakannut piipattamasta.	624771	624807	lehtonen1910a	3	36
Suolla porskuu vesi pieksujen alta.	500645	500680	lehtonen1910a	4	35
Suomalainen on itsepäinen.	662906	662932	lehtonen1910a	2	26
Suoraan kulkee hänen itsekseen kaatamansa reuna.	208486	208534	lehtonen1910a	5	48
Suoraan tupakkamaahansa pihan nurkkaukseen.	705943	705986	lehtonen1910a	3	43
Surulliseksi tulee koko Käkriäisen mieli.	389164	389205	lehtonen1910a	4	41
Suu oli vähän auki.	102016	102035	jarnefelt1916a	3	19
Suunnattoman kipeästi se koskee.	504084	504116	lehtonen1910a	3	32
Suurella melulla hänet tuotiin Topin kartanolle.	15955	16003	pakkala1895a	5	48
Suuri naarukuninkas.	264707	264727	lehtonen1910a	1	20
Suut huutamassa sanikoilla.	380514	380541	lehtonen1910a	2	27
Suutari Sinikanteleen eukko se on.	391840	391874	lehtonen1910a	4	34
Sydämeni oli pakahtua.	178304	178326	jarnefelt1916a	2	22
Sydämestään he olisivat suoneet hänen onnistuvan.	16316	16365	pakkala1895a	5	49
Sylkäisee yli aidan eikä virka mitään.	488282	488320	lehtonen1910a	5	38
Syntinen hän on.	322098	322114	lehtonen1910a	2	16
Syntinen on ihminen.	322115	322135	lehtonen1910a	2	20
Syntyi äänettömyys.	220798	220817	lassila1910a	1	19
Syntyi pitempi vaitiolo.	25970	25994	lassila1910a	2	24
Syntyi pitkä vaitiolo.	180833	180855	lassila1910a	2	22
Syntyi taas äänettömyys.	217357	217381	lassila1910a	2	24
Syntyy hiljaisuus.	752840	752858	lehtonen1910a	1	18
Syömmeköhän kastematoja kerman kanssa?	531480	531518	lehtonen1910a	3	38
Syrjittäin karmituolilla istuu Juutas.	331038	331076	lehtonen1910a	3	38
Sytyttää vielä kulon, se piippu.	382436	382468	lehtonen1910a	4	32
Syyspuolella se kävisi hyvin.	306263	306292	lehtonen1910a	3	29
Täältäpähän eivät ainakaan pieksäjät häntä löydä.	167060	167109	lehtonen1910a	5	49
Taas ei kuulu mitään.	123507	123528	jarnefelt1913a	3	21
Taas hän ummisti silmänsä.	212401	212427	canth1886a	3	26
Taas joovuksiss?	99059	99075	jarnefelt1913a	1	16
Taas katselivat he surullista pulloa.	48986	49023	lassila1910a	4	37
Taas kuuluu kodasta kolinaa.	675949	675977	lehtonen1910a	3	28
Taas on hiljaa.	123697	123712	jarnefelt1913a	2	15
Taas piti vaihtaa paikkoja.	69183	69210	jarnefelt1916a	3	27
Tähän viimeiseen ajatukseen minä lopullisesti pysähdyin.	174136	174192	jarnefelt1916a	5	56
Tahdoimme kumpikin pelastaa, niin.	13309	13343	jarnefelt1913a	3	34
Tahdoin nousta kapinaan omaa itseäni vastaan.	287293	287338	jarnefelt1916a	5	45
Tahdon olla heille uskollinen.	110572	110602	jarnefelt1916a	3	30
Tähkäiset oljenkorret kallistuvat heidän polulleen.	612635	612686	lehtonen1910a	4	51
Tahtoi vähän ujostuttaa se kosiomiehen pyytäminen.	16625	16675	lassila1910a	5	50
Tahtomalla häntä väkisin keittämään viinaa.	506358	506401	lehtonen1910a	4	43
Tahtovat rietastella.	735894	735915	lehtonen1910a	1	21
Tahvanainen tuskastui lopullisesti.	167020	167055	lassila1910a	2	35
Tähystelivät ympärilleen, vaan eivät nähneet mitään.	9191	9243	canth1886a	5	52
Tai hänen piippuaan.	103170	103190	lehtonen1910a	2	20
Tai Malakias, kuuletko sinä korvillasi?	694138	694177	lehtonen1910a	4	39
Tai matokassin teetä?	280193	280214	lehtonen1910a	2	21
Tai mitä lienevät olleet.	151074	151099	lehtonen1910a	3	25
Tai muustakaan maailmassa.	314337	314363	lehtonen1910a	2	26
Tai sanokaamme suoraan: kenraalikuvernööri käski.	45464	45513	jarnefelt1913a	4	49
Tai tietää edes, mitä ne ovat.	144555	144585	lehtonen1910a	5	30
Tai Tiitusta.	278283	278296	lehtonen1910a	1	13
Tai vielä köyhiä ihmisiä.	289784	289809	lehtonen1910a	3	25
Taide ei kuulu alaani.	799	821	jarnefelt1916a	3	22
Taikka aurinkoisella rannalla, maha paljaana.	765195	765240	lehtonen1910a	4	45
Taikka eikö tulisi ollenkaan?	133546	133575	canth1886a	3	29
Taikka heinäkuussa tähän aikaan.	358610	358642	lehtonen1910a	3	32
Taikka hyvän reen pituisessa sohvassa?	330311	330349	lehtonen1910a	4	38
Taikka kärventävät paljasta pintaansa rakolle auringonpaisteessa.	284122	284187	lehtonen1910a	5	65
Taikka mikä muu punkka tahansa.	184686	184717	lehtonen1910a	4	31
Taikka näki nälkää sen viikon.	52171	52201	lehtonen1910a	4	30
Taikka niinkuin lehmän mahalaukku, se satakerta.	694374	694422	lehtonen1910a	5	48
Taikka se pannaan lahtipenkkiin.	525739	525771	lehtonen1910a	3	32
Taikka Vaskilahteen, heittämään Käkriäiselle surmansilmukkaa kaulaan.	526296	526365	lehtonen1910a	5	69
Taivaalla on ainoastaan muutamia pilvenhaituvia.	58574	58622	lehtonen1910a	4	48
Taivaan reunalle nousee vaaleanpunaisia pilviä.	580182	580229	lehtonen1910a	4	47
Taivaasta.	210076	210086	canth1886a	0	10
Taivas on loistavan sininen.	584922	584950	lehtonen1910a	3	28
Taivas on luoteisen puolelta samea.	756517	756552	lehtonen1910a	4	35
Takaisin tullessakin Alma kulki mitään virkkamatta.	115382	115433	canth1886a	5	51
Takanapäin.	496015	496026	lehtonen1910a	0	11
Takapuolet ovat juuri seinän aukon kohdalla.	201028	201072	lehtonen1910a	5	44
Takki tuntui olevan niin lähellä ruumista.	110269	110311	pakkala1895a	5	42
Täksi päiväksi niitä on siellä vielä.	37940	37977	lehtonen1910a	5	37
Tällä hetkellä aivan, ja ijäksi?	131887	131919	canth1886a	4	32
Tällainen kelmiys.	501325	501343	lehtonen1910a	1	18
Tällaisella perheellä olisi nälkään näännytty.	740144	740190	lehtonen1910a	4	46
Tällaiset ovat Kenkkuinniemen rannikot.	3734	3773	lehtonen1910a	3	39
Tällaisia niistä lapsista tulee.	742935	742967	lehtonen1910a	3	32
Tällaisina päivinä tulevat mieleen entiset päivänpaisteet.	319839	319897	lehtonen1910a	5	58
Tällöin häneltä kuitenkin katkesi toinen hankavitsa.	79045	79097	jarnefelt1916a	5	52
Talon ruuissa.	301118	301132	lehtonen1910a	1	14
Talossa oli suuri suru.	99066	99089	lassila1910a	3	23
Talossa oltiin tulisessa kiireessä häävalmistuksien kanssa.	171113	171172	lassila1910a	5	59
Talossahan oli kiire.	87371	87392	lassila1910a	2	21
Talvella ei juuri yhtään kertaa.	190197	190229	lehtonen1910a	4	32
Tämä ajatus sekoitti minut pahan päiväisesti.	17334	17379	jarnefelt1913a	5	45
Tämä huuto kajahtaa selvästi pihalle.	498141	498178	lehtonen1910a	4	37
Tämä juttu vitsanantamisesta lapsille loukkasi Rosinaa.	243573	243628	lehtonen1910a	5	55
Tämä kaikki oli Jöijestä kuin satua.	75003	75039	jarnefelt1916a	5	36
Tämä löi Käkriäisen sydämelle pahan suuttumuksen.	360209	360258	lehtonen1910a	5	49
Tämä on jotain enempää kuin paratiisi.	5783	5821	jarnefelt1916a	5	38
Tämä on Putkinotkoa.	540462	540482	lehtonen1910a	2	20
Tämä on vanha heprealainen viisaus.	132831	132866	jarnefelt1913a	4	35
Tämä on varmaan metso.	174318	174340	lehtonen1910a	3	22
Tämä pudisti päätään.	235208	235229	canth1886a	2	21
Tämähän nyt on kuin Turkin sota.	678476	678508	lehtonen1910a	5	32
Tämähän se vasta pilkallinen onkin.	279139	279174	lehtonen1910a	4	35
Tämän huutaa Pertta portailla.	570119	570149	lehtonen1910a	3	30
Tämän Rosina tiuskahtaa.	521286	521310	lehtonen1910a	2	24
Tämän sanoo Lyygia rukoilevasti.	603535	603567	lehtonen1910a	3	32
Tämän vuoren juuressa on sakea lepikko.	612383	612422	lehtonen1910a	5	39
Tämäpä tuskastuttavaa.	139392	139414	jarnefelt1916a	1	22
Tamma alkoi juosta täyttä ravia.	52997	53029	lassila1910a	4	32
Tamma laukkasi.	55480	55495	lassila1910a	1	15
Tänään ei hän ajattele tällaisia.	329842	329875	lehtonen1910a	4	33
Tänään, kun hän ryhtyi siihen viina-asiaan.	464207	464250	lehtonen1910a	5	43
Tänlaista onnea saamme enää vaan sattumalta.	148180	148224	canth1886a	5	44
Tanssi.	147368	147375	jarnefelt1913a	0	7
Tapahtukoon Herran tahto.	92111	92136	jarnefelt1913a	2	25
Tapaus maalla, Suomessa.	89594	89618	jarnefelt1913a	2	24
Tapelleet olivat, natistaneet.	595402	595432	lehtonen1910a	2	30
Tapoin sen pois.	715194	715210	lehtonen1910a	2	16
Tappaako?	211263	211272	lehtonen1910a	0	9
Tappakoot.	688162	688172	lehtonen1910a	0	10
Tarinassa näet puhutaan viinasta.	750450	750483	lehtonen1910a	3	33
Tarinoimaan.	638782	638794	lehtonen1910a	0	12
Tärkeintä on Rosinasta nyt jauhojen saanti.	426512	426555	lehtonen1910a	5	43
Tarkoititte kai: yhdessä loppuun asti.	246601	246639	jarnefelt1916a	4	38
Tarvitseeko työn onnistua?	772166	772192	lehtonen1910a	2	26
Tarvitsethan, tarvitsethan sinä minua?	159058	159096	jarnefelt1913a	3	38
Tarvitsevathan ne lapset sellaisia.	584455	584490	lehtonen1910a	3	35
Tässä se on se hyvä paikka.	798140	798167	lehtonen1910a	5	27
Tauti se on.	505953	505965	lehtonen1910a	2	12
Täynnä keltaisia humalankäpyjä.	538956	538987	lehtonen1910a	2	31
Täysi pimeys.	154655	154668	jarnefelt1913a	1	13
Täytyihän herran silloin nurista.	775013	775046	lehtonen1910a	3	33
Täytyy ruveta kohta levolle.	223641	223669	canth1886a	3	28
Te ette usko meihin, neiti Kahila.	206719	206753	jarnefelt1916a	5	34
Te vissi näke uni, da?	115522	115544	jarnefelt1913a	4	22
Tee pian minkä teet.	154094	154114	jarnefelt1913a	3	20
Tehän tiedätte naiset.	12988	13010	jarnefelt1913a	2	22
Tehdä sitä pitäisi jotain.	787696	787722	lehtonen1910a	3	26
Tehkööt he nyt vuorostaan mitä voivat.	25142	25180	jarnefelt1916a	5	38
Teillä on patoja.	485453	485470	lehtonen1910a	2	17
Teki mieli vähän siistiytymäänkin.	24760	24794	lassila1910a	3	34
Temmoin ohjista minkä jaksoin joutuakseni apuun.	178327	178375	jarnefelt1916a	5	48
Tervahöyryjä kulkea jumpsuttaa.	390301	390332	lehtonen1910a	2	31
Tervan seassa.	568076	568090	lehtonen1910a	1	14
Terve tuloa Vasilj Vasiljevitsh.	103405	103437	jarnefelt1913a	3	32
Terve, sinä Putkinotko.	538988	539011	lehtonen1910a	2	23
Tiedän mitä sanotte.	204972	204992	jarnefelt1916a	2	20
Tiedän vain että he sitä ovat.	262618	262648	jarnefelt1916a	5	30
Tiedätkös sen?	495730	495744	lehtonen1910a	1	14
Tietysti Jöije ilostui Martin valasta sanomattomasti.	76176	76229	jarnefelt1916a	5	53
Tietysti omia rauenneita toiveitani.	27531	27567	jarnefelt1913a	3	36
Tietysti ovat kirkon rakentaneet jättiläiset.	79657	79702	jarnefelt1913a	4	45
Tietysti tämä kaikki oli pelkkää tekeytymistä.	32675	32721	jarnefelt1916a	5	46
Tietysti vastasit, ettet voi saapua.	157184	157220	jarnefelt1916a	4	36
Tiina Katri astui heti jäljessä.	86424	86456	canth1886a	4	32
Tiina Katri ensimmäisenä kiiruhti pihalle.	89836	89878	canth1886a	4	42
Tiina Katri heitti siihen ylenkatseellisen silmäyksen.	10061	10115	canth1886a	5	54
Tiina Katri juoksi.	78856	78875	canth1886a	2	19
Tiina Katri meni sisään lupakirjaa näyttämään.	87295	87341	canth1886a	5	46
Tiina Katri otti heidät kiinni.	90825	90856	canth1886a	4	31
Tiina Katrin limppu juohtui mieleen.	21945	21981	canth1886a	4	36
Tirkistelee totisin ja pelokkain silmin.	542177	542217	lehtonen1910a	4	40
Todella, kasvoni olivat aivan tomun tahraamat.	274059	274105	jarnefelt1916a	5	46
Toinen alkoi suuttua hänen väkistelyihinsä.	260644	260687	lassila1910a	4	43
Toinen jalka jo tuntui niin omituiselle.	103046	103086	pakkala1895a	5	40
Toinen kahvipannu kuohahtaa pankolle, viimeisen kerran.	438760	438815	lehtonen1910a	5	55
Toinen koputus ovelle.	148708	148730	jarnefelt1913a	2	22
Toinen oli Iivari ja toinen Risto.	124975	125009	pakkala1895a	5	34
Toinen, solakka, lienee Ananias.	536309	536341	lehtonen1910a	3	32
Toinenkin omituisuus pisti ompelijan silmiin.	228058	228103	canth1886a	4	45
Toisenlaista virvoitusta ne nyt tahtoisivat.	781259	781303	lehtonen1910a	4	44
Toisessa päässä lampea ylenee maisema komeana.	625622	625668	lehtonen1910a	5	46
Toiset väittävät, että minä sillä koketeeraan.	155951	155997	jarnefelt1916a	5	46
Toisetkin innostuivat heti siihen.	70216	70250	pakkala1895a	3	34
Toisia he sivuuttivat, toisia tuli vastaan.	236970	237013	canth1886a	5	43
Toisilla oli oikeus puolellaan.	29135	29166	pakkala1895a	3	31
Toisille niistä se pyllistää.	547901	547930	lehtonen1910a	3	29
Toisin sanoen: säälin tunteesta.	129808	129840	jarnefelt1916a	3	32
Toisinaan oli taas paha.	116963	116987	pakkala1895a	3	24
Toista se on potatti.	207922	207943	lehtonen1910a	3	21
Toista se on tämä Kenonen.	262720	262746	lassila1910a	4	26
Topi ajaa.	400515	400525	lehtonen1910a	1	10
Topi ei voi naurultaankaan vastata.	667813	667848	lehtonen1910a	4	35
Topi huutaa Moksia saamaan särkiä.	640143	640177	lehtonen1910a	4	34
Topi juoksee pakoon.	645558	645578	lehtonen1910a	2	20
Topi kapuaa kuopan reunalle kuuntelemaan.	396876	396917	lehtonen1910a	4	41
Topi katselee isänsä kiskomista.	401196	401228	lehtonen1910a	3	32
Topi kiroaa hupaisesti ja lähtee.	698566	698599	lehtonen1910a	4	33
Topi kiroilee sorakielellään.	121388	121417	lehtonen1910a	2	29
Topi kuuntelee suu auki ja ihmettelee.	221856	221894	lehtonen1910a	5	38
Topi mutisee epäselvästi jotain.	614405	614437	lehtonen1910a	3	32
Topi naurahtaa, mutta ei vastaa.	665885	665917	lehtonen1910a	4	32
Topi naurahtelee kainostellen.	629895	629925	lehtonen1910a	2	30
Topi on olevinaan kana.	641970	641993	lehtonen1910a	3	23
Topi on sorakielinen.	76574	76595	lehtonen1910a	2	21
Topi siirtyy Malakiaksen luokse lauteiden portaille.	671682	671734	lehtonen1910a	5	52
Topi suuttuu.	233463	233476	lehtonen1910a	1	13
Topi tuo, Aapeli juo.	720174	720195	lehtonen1910a	3	21
Topi vilkaisee isäänsä.	198265	198288	lehtonen1910a	2	23
Topi, etkö sinä lähde?	519663	519685	lehtonen1910a	3	22
Topikin rähähtää.	561194	561211	lehtonen1910a	1	17
Topilla on isänsä karvahattu korvilla.	614318	614356	lehtonen1910a	4	38
Topilta sai hän rahaa, ystävältään.	654093	654128	lehtonen1910a	4	35
Topin aikaan mörötti täyden kuukautensa.	520106	520146	lehtonen1910a	4	40
Topin mäki oli korkeampi kuin muut.	10005	10040	pakkala1895a	5	35
Topin on näet haettava tuvalta lamppu.	696931	696969	lehtonen1910a	5	38
Topin poikien toimeenpanema.	8362	8390	pakkala1895a	2	28
Torilla sattui olemaan joukko poikia.	153475	153512	lassila1910a	4	37
Torui heitä kuitenkin ja varoitteli.	28265	28301	canth1886a	4	36
Tosissaan hän ainoastaan rakasti minua.	17145	17184	jarnefelt1913a	4	39
Totisesti olet jo aikamies.	139553	139580	jarnefelt1913a	3	27
Tottelen, herr Befallningsman.	100514	100544	jarnefelt1913a	2	30
Tuijotti vaan, kun näki huulien käyvän.	212899	212938	canth1886a	5	39
Tuiskussa taivalsi hän suuren järven ylitse.	654327	654371	lehtonen1910a	5	44
Tukka roikkuu nurmelle.	642958	642981	lehtonen1910a	2	23
Tukka törröttää pitkänä Topin päässä.	76815	76852	lehtonen1910a	4	37
Tule ruualle.	597139	597152	lehtonen1910a	1	13
Tule sinäkin pitämään meille seuraa.	101996	102032	canth1886a	4	36
Tule tänne, tästä sinä näet hänet.	101364	101398	jarnefelt1916a	5	34
Tule tänne.	231297	231308	lehtonen1910a	1	11
Tule, veikkonen, lauteille.	701629	701656	lehtonen1910a	2	27
Tulee kevät.	6076	6088	lehtonen1910a	1	12
Tulee takaa, juoksee.	377636	377657	lehtonen1910a	2	21
Tulee ulos, painaa oven jälkeensä kiinni.	131004	131045	jarnefelt1913a	5	41
Tulen ahjosta syöksyivät hirvittävät kipinäpilvet ilmoihin.	179376	179435	jarnefelt1916a	5	59
Tulethan sinä meille harjaisia viettämään?	156731	156773	jarnefelt1916a	4	42
Tulevat lähemmäksi Topia.	614292	614317	lehtonen1910a	2	25
Tuli istumaan joka ilta.	715134	715158	lehtonen1910a	3	24
Tuli on apu tähän tuskan päivään.	504443	504476	lehtonen1910a	5	33
Tuli siitä lähtöaika.	31349	31370	lassila1910a	2	21
Tuli vieraita seuraavana päivänä.	135033	135066	canth1886a	3	33
Tulin kerran vähän mustasukkaiseksi.	280561	280597	jarnefelt1916a	3	36
Tulin kotiin.	83288	83301	jarnefelt1913a	1	13
Tulin myöhään yhteen taloon.	212697	212725	lehtonen1910a	3	28
Tulin saliin ennen paroonia.	31987	32015	jarnefelt1916a	3	28
Tulinen höyry, korvakkaista ja korvattomista kupeista.	440326	440380	lehtonen1910a	5	54
Tulisi siitäkin silloin markka tahi pari.	42083	42124	lehtonen1910a	5	41
Tulkoon Mauno väkineen heti Putkinotkoon.	310484	310525	lehtonen1910a	4	41
Tulonne ilahuttaisi varmaan suuresti heitäkin.	208625	208671	jarnefelt1916a	4	46
Tunnelma vähän alakuloinen.	91074	91101	jarnefelt1916a	2	27
Tunnen suussani kuolainten ankaran käskevät nykähdykset.	125565	125621	jarnefelt1913a	5	56
Tunnit vierivät.	171632	171648	canth1886a	1	16
Tunnustaakseni epäilin.	103506	103529	jarnefelt1913a	1	23
Tunnustako Maria se oma lapseks?	111132	111164	jarnefelt1913a	4	32
Tunnustan.	111244	111254	jarnefelt1913a	0	10
Tunnustelkaa: hän jo kylmenee.	156684	156714	jarnefelt1913a	3	30
Tunsin kovasti punehtuvani pelkästä kiukusta.	230536	230581	jarnefelt1916a	4	45
Tunsin olevani yhtä luonnon kanssa.	33848	33883	jarnefelt1913a	4	35
Tunsivat sen muutkin, sen ukon.	750882	750913	lehtonen1910a	4	31
Tuntee kuin itsessään jokaisen jäsenen muodon.	10404	10450	kilpi1903a	5	46
Tunti vierähti ja ympärillä hiljeni kaikki.	132994	133037	canth1886a	5	43
Tuntui helpommalle.	31743	31762	pakkala1895a	1	19
Tuntui kaikki niin somalle.	116842	116869	pakkala1895a	3	27
Tuntui kauhealle kaikista.	85958	85984	pakkala1895a	2	26
Tuntui niin hauskalle.	121758	121780	pakkala1895a	2	22
Tuntui niin syntiselle koko päivä.	76912	76946	pakkala1895a	4	34
Tuntui vain kivistävän päätä.	60337	60366	lassila1910a	3	29
Tuntui viimein kylmäävän, silloin hän nousi.	132456	132500	canth1886a	5	44
Tuntuu terveemmältä.	630282	630302	lehtonen1910a	1	20
Tuo ei ole mikään syy.	151203	151225	jarnefelt1913a	4	22
Tuo Poikako ne lienee tuonut, hölmö?	420340	420376	lehtonen1910a	5	36
Tuo Saarakos alkaa Lyygiaa suututtaa.	603111	603148	lehtonen1910a	4	37
Tuo se juuri voi myydä huljutusta.	273502	273536	lehtonen1910a	5	34
Tuo tänne, Petu, se täkki.	46185	46211	canth1886a	4	26
Tuohon, jossa Maunon Sanelma istuu.	729555	729590	lehtonen1910a	4	35
Tuoli on kuin mustalaisen hevosen selkä.	330083	330123	lehtonen1910a	5	40
Tuolla kauempana oli hovin karjaa.	384411	384445	lehtonen1910a	4	34
Tuolla kuvasteleiksen tuttavallinen nuottakota veteen.	650035	650089	lehtonen1910a	4	54
Tuolla menee Ananias.	233586	233607	lehtonen1910a	2	21
Tuolla näkyy taloja.	253509	253529	lehtonen1910a	2	20
Tuolla on pieni lahti metsän aukossa.	45139	45176	lehtonen1910a	5	37
Tuolla on ulapalle vievä syvä laivareitti.	2751	2793	lehtonen1910a	5	42
Tuollahan se Juutas äsken kävi.	73648	73679	lehtonen1910a	4	31
Tuollainen.	450373	450384	lehtonen1910a	0	11
Tuollaiset kuin tämä Mauno.	778555	778582	lehtonen1910a	3	27
Tuollaisia koivuisia.	538438	538459	lehtonen1910a	1	21
Tuolta tulee Leja, läävältä.	421749	421777	lehtonen1910a	3	28
Tuon Sanelman levollisuus ärsyttää häntä.	462274	462315	lehtonen1910a	4	41
Tuonne alas läävälle se nuuskii.	14803	14835	lehtonen1910a	4	32
Tuonne pakenivat kauemmas nuo väijyävät henget.	61071	61118	canth1886a	5	47
Tuonne väistyy mökki mäenrinteineen lahden perukkaan.	180561	180614	lehtonen1910a	5	53
Tuossa on Putkinotkon lampi vuoren alla.	611729	611769	lehtonen1910a	5	40
Tuossa on rahaa takaisin.	280523	280548	lehtonen1910a	3	25
Tuossa rauniolla nousee pensaina horsmia, purppurassaan.	584043	584099	lehtonen1910a	5	56
Tuossa se koira nyt istuu, Mauno.	497111	497144	lehtonen1910a	5	33
Tuosta saatte.	199559	199573	lehtonen1910a	1	14
Tupakatkin nimittäin unohtuvat joskus hakkaamatta.	48651	48701	lehtonen1910a	4	50
Tupakkakukkaro ja tulitikut ovat poissa.	383317	383357	lehtonen1910a	4	40
Tupakkamaassa se on.	385219	385239	lehtonen1910a	2	20
Turha vaiva; ei tullut mitään.	22666	22696	canth1886a	4	30
Turhaan kehotettiin senkin jäljestä anteeksi pyytämään.	73730	73785	pakkala1895a	5	55
Turhaan koetti Maija Liisa viihdyttää.	196184	196222	lassila1910a	4	38
Turtiainen oli jo neuvoton.	220585	220612	lassila1910a	3	27
Turtiainen yritti taas vähän lieventää asiaa.	219571	219616	lassila1910a	5	45
Tuskan hiki nousi hänelle otsaan.	23867	23900	canth1886a	4	33
Tuskin kehottaa hän siihen isoa Sanelmaa.	643690	643731	lehtonen1910a	5	41
Tuskin Saara sai pakettinsa toistaiseksi piiloon.	595067	595116	lehtonen1910a	5	49
Tutkivat ojansa reunoja.	396639	396663	lehtonen1910a	2	24
Tuttavia naisia tuli Almaa katsomaan.	166695	166732	canth1886a	4	37
Tuttunsa olen.	753186	753200	lehtonen1910a	1	14
Tuulenpesässäköhän tuulet syntyvät?	174958	174993	lehtonen1910a	2	35
Tuuli humisee hiljaa, koivun ritvat suhisevat.	175657	175703	lehtonen1910a	5	46
Tuuliviiri häämöttää mustana.	664154	664183	lehtonen1910a	2	29
Tuvan avonaisen seinän vieritse hän kulkee.	200984	201027	lehtonen1910a	5	43
Tuvan pankko hehkui niitä punaisenaan.	641761	641799	lehtonen1910a	4	38
Tuvan portailla on matikka.	385524	385551	lehtonen1910a	3	27
Tuvassa hän örähtää, jotain epäselvää.	156261	156299	lehtonen1910a	4	38
Tuvassa makaa mummo permannolla, oikoo kupeitaan.	385578	385627	lehtonen1910a	5	49
Tuvassa on hiljaista.	197912	197933	lehtonen1910a	2	21
Tuvasta se tuli ulos.	204348	204369	lehtonen1910a	3	21
Työ kävi Martin oman suunnitelman mukaan.	248849	248890	jarnefelt1916a	5	41
Työpuuskan tullessa möyrii Käkriäinen pellolla pyhänäkin.	105280	105337	lehtonen1910a	5	57
Tytöt eivät päässeet lähellekään.	50766	50799	pakkala1895a	3	33
Tytöt istuvat rotakollan perälaudalla.	233608	233646	lehtonen1910a	3	38
Tytöt katselivat Ullaa kysyvästi.	83805	83838	pakkala1895a	3	33
Tytöt olivat huutaen lähteneet hyppyyn.	66762	66801	pakkala1895a	4	39
Tytöt olivat näytelleet ne moneenkin kertaan.	637	682	pakkala1895a	5	45
Tytöt rupesivat itkemään.	99983	100008	pakkala1895a	2	25
Tytöt tulivat virkeiksi, hyppivät ja iloitsivat.	94619	94667	pakkala1895a	5	48
Tytöt yhtyivät ihan haltioihinsa.	2496	2529	pakkala1895a	3	33
Tyynen vasen käsi on Antonin kaulassa.	119189	119227	jarnefelt1913a	5	38
Tyyni ja Anton tulevat oikealta.	119156	119188	jarnefelt1913a	4	32
Tyyni vesi kuvastelee saaria.	45177	45206	lehtonen1910a	3	29
Uikuttaen se juoksee Topin haarojen väliin.	541464	541507	lehtonen1910a	5	43
Uivat.	284115	284121	lehtonen1910a	0	6
Ukko Hyvärinen väänsi lehmien kytkytvitsoja.	175888	175932	lassila1910a	4	44
Ukkosen huurua se lienee.	389883	389908	lehtonen1910a	3	25
Ulapalla käy tuskin hienoja väreitä.	390148	390184	lehtonen1910a	4	36
Ulapan ylitse kaareutuu illan punertava taivas.	650338	650385	lehtonen1910a	5	47
Ulappa muuttuu vähitellen omituisesti punansinertäväksi.	610792	610848	lehtonen1910a	4	56
Ulla epäröi.	96260	96272	pakkala1895a	1	12
Ulla ihan vavahti.	88267	88285	pakkala1895a	2	18
Ulla joutui hämilleen.	86588	86610	pakkala1895a	2	22
Ulla kulki vielä edelleen.	94127	94153	pakkala1895a	3	26
Ulla lähti päättävästi liikkeelle.	90876	90910	pakkala1895a	3	34
Ulla lappoi kaikki helmaansa.	87566	87595	pakkala1895a	3	29
Ulla oli tyyni ja rauhoitti heitä.	90467	90501	pakkala1895a	5	34
Ulla oli vähän aikaa epäröivän näköinen.	85531	85571	pakkala1895a	5	40
Ulla sai sanotuksi ainoastaan: jalka.	103166	103203	pakkala1895a	4	37
Ulla säikähti.	95455	95469	pakkala1895a	1	14
Ulla seisoi ja vapisi.	95877	95899	pakkala1895a	3	22
Ulla sylkäisi kämmenelleen, uudisti koko konstinsa.	90974	91025	pakkala1895a	5	51
Ulla tunkeutui toisten keskelle, heidän turviinsa.	99164	99214	pakkala1895a	5	50
Ulla vai kytrötti liikkumatta.	99614	99644	pakkala1895a	3	30
Ulla vakuutti.	91353	91367	pakkala1895a	1	14
Ullalle he lupasivat kukin yhden mitallisen.	92986	93030	pakkala1895a	5	44
Ullasta tuntui aivan kuin hän pakahtuisi.	102945	102986	pakkala1895a	5	41
Ulos ryntäsi matalajalkainen Hurja.	417686	417721	lehtonen1910a	3	35
Umpimähkään porhalsivat miehet taas eteenpäin.	152896	152942	lassila1910a	4	46
Unettomuuden tähden varmaan; täytyi päästä levolle.	31395	31446	canth1886a	5	51
Uni kammoitti häntä vieläkin.	230690	230719	canth1886a	3	29
Unta se raukka tarvitsee.	117880	117905	jarnefelt1913a	3	25
Upota kuin kaivoon.	472288	472307	lehtonen1910a	2	19
Uskaltaisiko mennä koettamaan?	22067	22097	canth1886a	2	30
Uskaltaisikohan mummo edes liikahtaa?	388488	388525	lehtonen1910a	3	37
Uskoivatpas varmaankin.	795317	795340	lehtonen1910a	1	23
Uteliaisuuteni heräsi.	13335	13357	jarnefelt1916a	1	22
Uudelleen hän pujoi nyrkkiään Petulle.	12199	12237	canth1886a	4	38
Uudestaan hän on vaiti.	147733	147756	lehtonen1910a	3	23
Va't sii', Poikaa.	679800	679818	lehtonen1910a	2	18
Vaaleanpunainen satiinipusero.	131705	131735	lehtonen1910a	1	30
Vaan hän ei tullut.	132247	132266	canth1886a	3	19
Vaan rötkötti.	595638	595652	lehtonen1910a	1	14
Vääryydeltä näytti kuolemani.	41696	41725	jarnefelt1913a	2	29
Vaatisikohan se taas tilille?	707797	707826	lehtonen1910a	3	29
Vaatteet olivat märät, kengät kurassa.	200680	200718	lassila1910a	4	38
Vähäistä kolinaa, niinkuin kyökkitoimissa oltaessa.	154925	154976	jarnefelt1913a	4	51
Vähän ajan kuluttua tömisee piha.	554779	554812	lehtonen1910a	4	33
Vähitellen ihmiset menivät mikä minnekin.	419758	419799	lehtonen1910a	4	41
Vai ei.	248503	248510	lehtonen1910a	1	7
Vai eikö Muttinen, vanha mies, saane?	556533	556570	lehtonen1910a	5	37
Vai et.	515045	515052	lehtonen1910a	1	7
Vai heinäsirkkoja ja metsähunajaa?	531519	531553	lehtonen1910a	3	34
Vai hiirenhäntiäkö?	531554	531573	lehtonen1910a	1	19
Vai itse metsänkukko?	172149	172170	lehtonen1910a	2	21
Vai jäniksen vettä?	280173	280192	lehtonen1910a	2	19
Vai kipsjaakoppiako?	280097	280117	lehtonen1910a	1	20
Vai kuinka minun pitäisi ajatella Jöijeä?	250638	250679	jarnefelt1916a	5	41
Vai lepäämistäkö on kauniina oleminen?	34112	34150	kilpi1903a	4	38
Vai mitä, Pertta?	569871	569888	lehtonen1910a	2	17
Vai oliko jo kaikki raunioina?	178460	178490	jarnefelt1916a	4	30
Vai onko ollenkaan elämää?	96760	96786	kilpi1903a	3	26
Vai paiskataanko karierijäärnestiä?	280050	280085	lehtonen1910a	2	35
Vai Putkinotkon jumala nykyään?	349844	349875	lehtonen1910a	3	31
Vai toi se Sinikanteleen vaimo lehmäänsä.	424905	424946	lehtonen1910a	5	41
Vai vatsa mummolla kipeä?	279994	280019	lehtonen1910a	3	25
Vaikea on hänen selviytyä paksussa raamatussa.	76637	76683	jarnefelt1913a	5	46
Vaikea on sanoin kuvata Kaisan hämmästystä.	223630	223673	lassila1910a	5	43
Vaikka ei voittaisikaan.	11792	11816	pakkala1895a	2	24
Vaikka kysyisitte.	623333	623351	lehtonen1910a	1	18
Vaikka Muttisen rouva lähetti sanikoillesi vaatteitakin.	496027	496083	lehtonen1910a	5	56
Vaikka on lähes aikaihminen.	55887	55915	lehtonen1910a	3	28
Vaikka Sinikanteleen akkakin oli varottanut.	429420	429464	lehtonen1910a	4	44
Vaikkei ole takapäässä kuin kynäntynkiä.	40092	40132	lehtonen1910a	4	40
Vaikkei tuon vävyn tähden tarvitsisikaan.	74964	75005	lehtonen1910a	4	41
Vaimo parat olivat yhä tulitikkujen puutteessa.	191107	191154	lassila1910a	5	47
Vaimot taukosivat työstään ja kuuntelivat.	97743	97785	canth1886a	4	42
Vain haudepata kodassa porisee.	674914	674945	lehtonen1910a	3	31
Vain ketut etäällä äännähtelevät.	6020	6053	lehtonen1910a	3	33
Vain linnut veisaavat lehdossa.	45047	45078	lehtonen1910a	3	31
Vain lisää lapsia heillä.	768138	768163	lehtonen1910a	3	25
Vain neuvo tuollaisille tuttaville.	778768	778803	lehtonen1910a	3	35
Vain tuokion oli päivällä heikkoa tuulta.	610730	610771	lehtonen1910a	5	41
Vaipan helmakulmat jo erottuvat.	131140	131172	jarnefelt1913a	3	32
Vaivoin eroittaa Rosinakaan sitä puhelua.	490898	490939	lehtonen1910a	4	41
Vaivoin pääsee siitä henki.	272514	272541	lehtonen1910a	3	27
Vaivoin sai pidätetyksi.	115562	115586	pakkala1895a	2	24
Väkisinkin siinä alkoi kiukuttaa.	203363	203396	lassila1910a	3	33
Valako?	172917	172924	jarnefelt1916a	0	7
Valehtelet.	622394	622405	lehtonen1910a	0	11
Välikössä puuhailee Leja lehmäntuojan kanssa.	391441	391486	lehtonen1910a	4	45
Välillä puhuttiin Kämäräisen lehmästä.	82717	82755	lassila1910a	3	38
Välistä se vain hiljaa röhkäisee.	43068	43101	lehtonen1910a	4	33
Väliverho.	159888	159898	jarnefelt1913a	0	10
Valkoinen koira tähystelee järvestä omaa kuvaistaan.	650126	650178	lehtonen1910a	5	52
Vallesmanni toi kuvernöriltä käskyn kasarmiin.	45417	45463	jarnefelt1913a	4	46
Vallitsee melkein hiljaisuus.	145584	145613	lehtonen1910a	2	29
Valot ovat sammuksissa.	63818	63841	jarnefelt1913a	2	23
Valtiopäivämies-vaalista John ja Lagander puhuivat.	144350	144401	canth1886a	4	51
Vanha ja valkeapilkkuinen kana, mökin ainoa.	18295	18339	lehtonen1910a	5	44
Vanha on vanha.	41283	41298	lehtonen1910a	2	15
Vanha rakkaus iti.	117340	117358	lassila1910a	2	18
Vanha rakkauskin unohtui.	134693	134718	lassila1910a	2	25
Vanha ukko, kuusissakymmenissä, elää vieläkin.	753201	753247	lehtonen1910a	4	46
Vanha, tuttu huone, tuttuja esineitä kaikki.	212281	212325	canth1886a	5	44
Vanhaksi tulen.	766573	766588	lehtonen1910a	1	15
Vapoja on siinä, Muttisen ja neidin.	646857	646893	lehtonen1910a	5	36
Vappu kävi asioilla ja sai piiskoja.	53302	53338	pakkala1895a	5	36
Vappu muisti aina.	62657	62675	pakkala1895a	2	18
Vappu oli ihmeissään.	62341	62362	pakkala1895a	2	21
Vapusta oli melkein kuin unta.	56380	56410	pakkala1895a	4	30
Var det rätt så?	94055	94071	jarnefelt1913a	3	16
Varjon puolelta se heisi tupaan pilkistelee.	117636	117680	lehtonen1910a	5	44
Varmaan on jotain esteitä.	165813	165839	jarnefelt1916a	3	26
Varmaan siellä sataa.	511502	511523	lehtonen1910a	2	21
Varmaankin Sahan hovilla.	45112	45137	lehtonen1910a	2	25
Varsan pää hetkahtaa jälleen pystyyn.	123153	123190	jarnefelt1913a	4	37
Varsin tyytyväisenä hän täyttää nyt piippunsa.	162582	162628	lehtonen1910a	5	46
Varsinkaan akkojen pousaamista.	161167	161198	lehtonen1910a	2	31
Varsinkin herrasväki.	20628	20649	pakkala1895a	1	21
Vasemman käden nimettömässä on Saaralla sormus.	135223	135270	lehtonen1910a	5	47
Vaskilahden lehmiä varmaankin.	384380	384410	lehtonen1910a	2	30
Vaskilahden Matti.	493262	493280	lehtonen1910a	1	18
Vasta aamupuoleen meni Alma uneen.	235231	235265	canth1886a	4	34
Vastaani lehahtaa lämmin ilma.	214879	214909	jarnefelt1916a	3	30
Vastahan se oli.	658172	658188	lehtonen1910a	2	16
Vastarakkautta hän ei alunalkaen toivonutkaan.	151315	151361	canth1886a	4	46
Vastarannalla syttyy kirkas tuli.	763346	763379	lehtonen1910a	3	33
Vastat hutkivat.	717659	717675	lehtonen1910a	1	16
Vastausta ei kuulunut.	9267	9289	canth1886a	2	22
Vastenmieliseltä tuntuu Käkriäisestä outojen vieraiden tuleminen.	527484	527549	lehtonen1910a	5	65
Vastoillaan hosuen pääsee Perttakin pihalle.	686106	686150	lehtonen1910a	4	44
Väsyttää.	321042	321051	lehtonen1910a	0	9
Vatanen mietti sitä Hyvärisen tytön kosimista.	16996	17042	lassila1910a	5	46
Vedet juoksevat suurina pisaroina hänen silmistään.	226588	226639	lehtonen1910a	5	51
Vedet silmiin tulivat minulla.	80229	80259	pakkala1895a	3	30
Vehnäjauhojakin on.	367542	367561	lehtonen1910a	1	19
Velvollisuus.	98109	98122	jarnefelt1913a	0	13
Vene totteli.	77481	77494	jarnefelt1916a	1	13
Veneessä on valkeaa: naisihminen.	528651	528684	lehtonen1910a	3	33
Vesi lemuaa.	626735	626747	lehtonen1910a	1	12
Vielä ajoivat he tuokion.	533666	533691	lehtonen1910a	3	25
Vielä ei John tiennyt mitään.	226223	226252	canth1886a	4	29
Vielä lienee tuolla emaljipannussa kahvia.	441554	441596	lehtonen1910a	4	42
Vielä sininen mekko sängyn alle.	547522	547554	lehtonen1910a	4	32
Vielä vähemmän kokonaisesta valtakunnasta.	46516	46558	jarnefelt1913a	3	42
Vieläkään ei Rosina lähde saunaan.	735115	735149	lehtonen1910a	4	34
Vieläkö sinä osaat?	553117	553136	lehtonen1910a	2	19
Vieläpä siinä suhteessa aivan tyypillinen filosoofi.	224468	224520	jarnefelt1916a	5	52
Vietiin kirkon hautaan.	673707	673730	lehtonen1910a	2	23
Vihassa päätti Jaakko hänen olevan.	5084	5119	pakkala1895a	4	35
Vihdoin hän huomasi kyyneleeni.	25514	25545	jarnefelt1913a	3	31
Vihdoin lakkasi läiske ja puhina.	42171	42204	lassila1910a	4	33
Vihdoin oli elokuun lopulla kaikki valmista.	277907	277951	jarnefelt1916a	5	44
Vihdoin varsa alkaa yhä levottomammin tanssahdella.	131897	131948	jarnefelt1913a	5	51
Vihoissaan puree hän piippunsa katkennutta imuketta.	479282	479334	lehtonen1910a	5	52
Vihoissaan töykkäisee Sanelma vielä Luukasta leukaankin.	226726	226782	lehtonen1910a	5	56
Vihtakannan mökissä saamme ruokaa ja kahvia.	199571	199615	canth1886a	5	44
Viidentoista vanha on vasta Leja.	228771	228804	lehtonen1910a	4	33
Viime kesänä he riitelivät aina, aina.	607722	607760	lehtonen1910a	5	38
Viime sanat puhuu Lyygia Muttiselle.	552871	552907	lehtonen1910a	4	36
Viimein joutuu hän niitylle.	208068	208096	lehtonen1910a	3	28
Viimein katsoi Nymark säikähtyen kelloonsa.	171876	171919	canth1886a	4	43
Viimein löysi Antti taas alun.	146811	146841	lassila1910a	4	30
Viimein ne olisivat voineet alkaa.	562103	562137	lehtonen1910a	4	34
Viimeinen hätä oli käsissä.	62224	62251	lassila1910a	3	27
Viimeinkin hän ne otti.	26751	26774	lehtonen1910a	3	23
Viimeinkin.	377498	377509	lehtonen1910a	0	11
Viimeisenä pienen ja viattoman Luukas-raiskan.	504001	504047	lehtonen1910a	4	46
Viimeistely oli minulle täydellinen yllätys.	164118	164162	jarnefelt1916a	4	44
Viimemainittua neuvoa seurattiinkin.	22012	22048	jarnefelt1916a	2	36
Viimesyksyinen oli ihan viimeinen yritys.	778904	778945	lehtonen1910a	4	41
Viina alkoi nousta päähän.	51731	51757	lassila1910a	3	26
Viinan rokaamisesta, pirulainen.	491454	491486	lehtonen1910a	2	32
Viinankuljettajia.	762154	762172	lehtonen1910a	0	18
Viinastako se Malakias oli puhunut?	704321	704356	lehtonen1910a	4	35
Ville jänistämään.	13771	13789	pakkala1895a	1	18
Ville kehui itseään ja komeili.	8808	8839	pakkala1895a	4	31
Ville oli ihmeissään.	185562	185583	lassila1910a	2	21
Ville rupesi uudelleen tuskittelemaan.	47244	47282	canth1886a	3	38
Ville seisoi heitä aivan lähellä.	35154	35187	canth1886a	4	33
Villen mieltä karvasteli.	14623	14648	pakkala1895a	2	25
Virren veisattuaan he taas vaikenivat.	206212	206250	lassila1910a	4	38
Vitsa oli seinän raossa.	11780	11804	canth1886a	3	24
Voi Ananias.	233858	233870	lehtonen1910a	1	12
Voi siellä olla muitakin, ihan vieraita.	527136	527176	lehtonen1910a	5	40
Voitteko selittää?	10935	10953	jarnefelt1913a	1	18
Vouz trouvez?	104235	104248	jarnefelt1913a	1	13
Vuolisi Alarikille hevosia.	115228	115255	pakkala1895a	2	27
Vuori kaikuu melkein pienimmätkin äänet.	796251	796291	lehtonen1910a	4	40
Vuoteella hän oli päivän toisensa jälkeen.	221748	221790	canth1886a	5	42
Vuoteen jalkapuolella korinojatuoli mattoineen ja jakkaroineen.	137890	137953	jarnefelt1913a	5	63
Vuoteen lämpimässä oli hänen hyvä olla.	211284	211323	canth1886a	5	39
Yhä hän vain ajatteli asian juurta.	274538	274573	lassila1910a	5	35
Yhä kiukkuisemmaksi on se viha tullut.	776269	776307	lehtonen1910a	5	38
Yhä pitemmät ajat on lintu vaiti.	632559	632592	lehtonen1910a	5	33
Yhä sataa.	357965	357975	lehtonen1910a	1	10
Yhä se huutaa.	396761	396775	lehtonen1910a	2	14
Yhä vain tehdään uusia vaatteita.	245075	245108	lehtonen1910a	4	33
Yhden piipullisen hän vetää.	381430	381458	lehtonen1910a	3	28
Yhdessä he kaksi menevät saunaan.	728169	728202	lehtonen1910a	4	33
Yhdessä olemme myyneet, tunnen ostajat.	492059	492098	lehtonen1910a	4	39
Yht'äkkiä Ville alkoi riisua kiireellä kenkiään.	13939	13987	pakkala1895a	5	48
Yhtä harmaata ja vähäpätöistä kaikki.	1433	1470	jarnefelt1913a	4	37
Yhtäkkiä kuuluu saunasta Malakiaksen karjahdus.	724606	724653	lehtonen1910a	4	47
Yhtäkkiä nostavat he sieltä päätänsä.	396664	396701	lehtonen1910a	4	37
Yhtäkkiä parkaisee Luukas taas itkuun.	226549	226587	lehtonen1910a	4	38
Yhtäkkiä se urahti ja nousi jaloilleen.	623545	623584	lehtonen1910a	5	39
Yhtäkkiä tapaa hän kalliolta kuivuneen lehmänlannan.	725508	725560	lehtonen1910a	5	52
Yhtäkkiä tohahti sitten Muttinen rannalle.	571721	571763	lehtonen1910a	4	42
Yksi liekki tavoittaa alimmaista vuorilautaa.	507422	507467	lehtonen1910a	4	45
Yksin sallittuakin vastaan kamppailee.	757169	757207	lehtonen1910a	3	38
Yksinään oli Jopi pysyttäytynyt siellä.	430601	430640	lehtonen1910a	4	39
Ylhäältä töyryltä, jolla mökki on.	626351	626385	lehtonen1910a	4	34
Yli rusahtelevien aitojen, läpi kahisevien pehkojen.	500681	500733	lehtonen1910a	5	52
Ylimenon siltaa on aivan helppo kulkea.	28835	28874	jarnefelt1916a	5	39
Ylimmäisenä sen emäntäneidin rämpättävä huuto.	341719	341765	lehtonen1910a	4	46
Ylinnä kuului Käkriäisen ääni.	621219	621249	lehtonen1910a	3	30
Ylitse kaikkea.	117943	117958	canth1886a	1	15
Ylpeä se oli ollut kesällä.	549839	549866	lehtonen1910a	4	27
Ylpeänä kantakoon ihminen surunsa.	140612	140646	jarnefelt1913a	3	34
Ylpeyttä siinä ei ole rahtuakaan.	203777	203810	jarnefelt1916a	4	33
Ymmärän, herr Befallningsman.	100136	100165	jarnefelt1913a	2	29
Ymmärrän, herr Befallningsman.	100255	100285	jarnefelt1913a	2	30
Ymmärtämättömyydestä.	65160	65181	jarnefelt1913a	0	21
Ymmärtäväthän nuo meidän lapset sen verran.	519428	519471	lehtonen1910a	5	43
Yninä vaikenee jälleen.	18111	18134	lehtonen1910a	2	23
Yömin hän oli varmasti tuntenut.	633296	633328	lehtonen1910a	4	32
Yömyöhällä.	387303	387314	lehtonen1910a	0	11
Yöpimeään viipyi hän metsässä.	288916	288946	lassila1910a	3	30
Z. Topelius, vert.	73626	73644	jarnefelt1913a	2	18
